"filename", "language", "JSON", "Lua", "Markdown", "JavaScript", "comment", "blank", "total"
"d:\ROBLOX STUDIO\Rojo\UTP\src\ReplicatedFirst\GameLoading\GameLoadingService.lua", "Lua", 0, 57, 0, 0, 3, 19, 79
"d:\ROBLOX STUDIO\Rojo\UTP\src\ReplicatedFirst\GameLoading\init.meta.json", "JSON", 1, 0, 0, 0, 0, 0, 1
"d:\ROBLOX STUDIO\Rojo\UTP\src\ReplicatedStorage\ClientServices\GuiServices.lua", "Lua", 0, 165, 0, 0, 6, 93, 264
"d:\ROBLOX STUDIO\Rojo\UTP\src\ReplicatedStorage\ClientServices\Inputs.lua", "Lua", 0, 52, 0, 0, 5, 28, 85
"d:\ROBLOX STUDIO\Rojo\UTP\src\ReplicatedStorage\ClientServices\PetClientsService.lua", "Lua", 0, 43, 0, 0, 1, 40, 84
"d:\ROBLOX STUDIO\Rojo\UTP\src\ReplicatedStorage\ClientServices\SkillAnimator.lua", "Lua", 0, 110, 0, 0, 6, 53, 169
"d:\ROBLOX STUDIO\Rojo\UTP\src\ReplicatedStorage\ClientServices\SubServices\SkillEffects.lua", "Lua", 0, 77, 0, 0, 0, 43, 120
"d:\ROBLOX STUDIO\Rojo\UTP\src\ReplicatedStorage\ClientServices\TycoonClientServices.lua", "Lua", 0, 196, 0, 0, 4, 87, 287
"d:\ROBLOX STUDIO\Rojo\UTP\src\ReplicatedStorage\ClientServices\init.meta.json", "JSON", 3, 0, 0, 0, 0, 0, 3
"d:\ROBLOX STUDIO\Rojo\UTP\src\ReplicatedStorage\Drops\Drop1\BillboardGui\Script.server.lua", "Lua", 0, 7, 0, 0, 0, 9, 16
"d:\ROBLOX STUDIO\Rojo\UTP\src\ReplicatedStorage\Drops\Drop1\BillboardGui\init.meta.json", "JSON", 4, 0, 0, 0, 0, 0, 4
"d:\ROBLOX STUDIO\Rojo\UTP\src\ReplicatedStorage\Drops\Drop1\init.meta.json", "JSON", 4, 0, 0, 0, 0, 0, 4
"d:\ROBLOX STUDIO\Rojo\UTP\src\ReplicatedStorage\Drops\Drop2\BillboardGui\Script.server.lua", "Lua", 0, 7, 0, 0, 0, 9, 16
"d:\ROBLOX STUDIO\Rojo\UTP\src\ReplicatedStorage\Drops\Drop2\BillboardGui\init.meta.json", "JSON", 4, 0, 0, 0, 0, 0, 4
"d:\ROBLOX STUDIO\Rojo\UTP\src\ReplicatedStorage\Drops\Drop2\init.meta.json", "JSON", 4, 0, 0, 0, 0, 0, 4
"d:\ROBLOX STUDIO\Rojo\UTP\src\ReplicatedStorage\Drops\Drop3\BillboardGui\Script.server.lua", "Lua", 0, 7, 0, 0, 0, 9, 16
"d:\ROBLOX STUDIO\Rojo\UTP\src\ReplicatedStorage\Drops\Drop3\BillboardGui\init.meta.json", "JSON", 4, 0, 0, 0, 0, 0, 4
"d:\ROBLOX STUDIO\Rojo\UTP\src\ReplicatedStorage\Drops\Drop3\init.meta.json", "JSON", 4, 0, 0, 0, 0, 0, 4
"d:\ROBLOX STUDIO\Rojo\UTP\src\ReplicatedStorage\Drops\Drop4\BillboardGui\Script.server.lua", "Lua", 0, 7, 0, 0, 0, 9, 16
"d:\ROBLOX STUDIO\Rojo\UTP\src\ReplicatedStorage\Drops\Drop4\BillboardGui\init.meta.json", "JSON", 4, 0, 0, 0, 0, 0, 4
"d:\ROBLOX STUDIO\Rojo\UTP\src\ReplicatedStorage\Drops\Drop4\init.meta.json", "JSON", 4, 0, 0, 0, 0, 0, 4
"d:\ROBLOX STUDIO\Rojo\UTP\src\ReplicatedStorage\Drops\init.meta.json", "JSON", 3, 0, 0, 0, 0, 0, 3
"d:\ROBLOX STUDIO\Rojo\UTP\src\ReplicatedStorage\EggDataMeta.lua", "Lua", 0, 99, 0, 0, 12, 19, 130
"d:\ROBLOX STUDIO\Rojo\UTP\src\ReplicatedStorage\EggsData.lua", "Lua", 0, 170, 0, 0, 1, 14, 185
"d:\ROBLOX STUDIO\Rojo\UTP\src\ReplicatedStorage\FormatNumber\Custom.lua", "Lua", 0, 15, 0, 0, 0, 14, 29
"d:\ROBLOX STUDIO\Rojo\UTP\src\ReplicatedStorage\FormatNumber\Main\.source.lua", "Lua", 0, 166, 0, 0, 6, 30, 202
"d:\ROBLOX STUDIO\Rojo\UTP\src\ReplicatedStorage\FormatNumber\Main\DecimalFormatSymbols.lua", "Lua", 0, 35, 0, 0, 0, 8, 43
"d:\ROBLOX STUDIO\Rojo\UTP\src\ReplicatedStorage\FormatNumber\Main\IntegerWidth.lua", "Lua", 0, 32, 0, 0, 1, 8, 41
"d:\ROBLOX STUDIO\Rojo\UTP\src\ReplicatedStorage\FormatNumber\Main\Notation.lua", "Lua", 0, 92, 0, 0, 2, 22, 116
"d:\ROBLOX STUDIO\Rojo\UTP\src\ReplicatedStorage\FormatNumber\Main\Precision.lua", "Lua", 0, 148, 0, 0, 1, 30, 179
"d:\ROBLOX STUDIO\Rojo\UTP\src\ReplicatedStorage\FormatNumber\Main\init.lua", "Lua", 0, 166, 0, 0, 4, 29, 199
"d:\ROBLOX STUDIO\Rojo\UTP\src\ReplicatedStorage\FormatNumber\Simple.lua", "Lua", 0, 53, 0, 0, 4, 19, 76
"d:\ROBLOX STUDIO\Rojo\UTP\src\ReplicatedStorage\FormatNumber\Version.lua", "Lua", 0, 65, 0, 0, 4, 13, 82
"d:\ROBLOX STUDIO\Rojo\UTP\src\ReplicatedStorage\FormatNumber\_internal\.source.lua", "Lua", 0, 8, 0, 0, 0, 0, 8
"d:\ROBLOX STUDIO\Rojo\UTP\src\ReplicatedStorage\FormatNumber\_internal\class.lua", "Lua", 0, 168, 0, 0, 5, 31, 204
"d:\ROBLOX STUDIO\Rojo\UTP\src\ReplicatedStorage\FormatNumber\_internal\decimal_conversion.lua", "Lua", 0, 25, 0, 0, 0, 5, 30
"d:\ROBLOX STUDIO\Rojo\UTP\src\ReplicatedStorage\FormatNumber\_internal\enums.lua", "Lua", 0, 53, 0, 0, 0, 2, 55
"d:\ROBLOX STUDIO\Rojo\UTP\src\ReplicatedStorage\FormatNumber\_internal\format.lua", "Lua", 0, 286, 0, 0, 7, 49, 342
"d:\ROBLOX STUDIO\Rojo\UTP\src\ReplicatedStorage\FormatNumber\_internal\formatter_settings.lua", "Lua", 0, 141, 0, 0, 1, 18, 160
"d:\ROBLOX STUDIO\Rojo\UTP\src\ReplicatedStorage\FormatNumber\_internal\init.lua", "Lua", 0, 8, 0, 0, 0, 0, 8
"d:\ROBLOX STUDIO\Rojo\UTP\src\ReplicatedStorage\FormatNumber\_internal\skeleton.lua", "Lua", 0, 453, 0, 0, 9, 79, 541
"d:\ROBLOX STUDIO\Rojo\UTP\src\ReplicatedStorage\FormatNumber\init.meta.json", "JSON", 3, 0, 0, 0, 0, 0, 3
"d:\ROBLOX STUDIO\Rojo\UTP\src\ReplicatedStorage\MinionsData.lua", "Lua", 0, 53, 0, 0, 0, 17, 70
"d:\ROBLOX STUDIO\Rojo\UTP\src\ReplicatedStorage\Module3D.lua", "Lua", 0, 160, 0, 0, 43, 44, 247
"d:\ROBLOX STUDIO\Rojo\UTP\src\ReplicatedStorage\Packages\_Index\evaera_cmdr@1.12.0\cmdr\CHANGELOG.md", "Markdown", 0, 0, 184, 0, 0, 38, 222
"d:\ROBLOX STUDIO\Rojo\UTP\src\ReplicatedStorage\Packages\_Index\evaera_cmdr@1.12.0\cmdr\Cmdr\BuiltInCommands\Admin\announce.lua", "Lua", 0, 13, 0, 0, 0, 0, 13
"d:\ROBLOX STUDIO\Rojo\UTP\src\ReplicatedStorage\Packages\_Index\evaera_cmdr@1.12.0\cmdr\Cmdr\BuiltInCommands\Admin\announceServer.lua", "Lua", 0, 12, 0, 0, 0, 3, 15
"d:\ROBLOX STUDIO\Rojo\UTP\src\ReplicatedStorage\Packages\_Index\evaera_cmdr@1.12.0\cmdr\Cmdr\BuiltInCommands\Admin\gotoPlace.lua", "Lua", 0, 28, 0, 0, 0, 0, 28
"d:\ROBLOX STUDIO\Rojo\UTP\src\ReplicatedStorage\Packages\_Index\evaera_cmdr@1.12.0\cmdr\Cmdr\BuiltInCommands\Admin\gotoPlaceServer.lua", "Lua", 0, 18, 0, 0, 0, 6, 24
"d:\ROBLOX STUDIO\Rojo\UTP\src\ReplicatedStorage\Packages\_Index\evaera_cmdr@1.12.0\cmdr\Cmdr\BuiltInCommands\Admin\kick.lua", "Lua", 0, 13, 0, 0, 0, 0, 13
"d:\ROBLOX STUDIO\Rojo\UTP\src\ReplicatedStorage\Packages\_Index\evaera_cmdr@1.12.0\cmdr\Cmdr\BuiltInCommands\Admin\kickServer.lua", "Lua", 0, 6, 0, 0, 0, 1, 7
"d:\ROBLOX STUDIO\Rojo\UTP\src\ReplicatedStorage\Packages\_Index\evaera_cmdr@1.12.0\cmdr\Cmdr\BuiltInCommands\Admin\kill.lua", "Lua", 0, 13, 0, 0, 0, 0, 13
"d:\ROBLOX STUDIO\Rojo\UTP\src\ReplicatedStorage\Packages\_Index\evaera_cmdr@1.12.0\cmdr\Cmdr\BuiltInCommands\Admin\killServer.lua", "Lua", 0, 8, 0, 0, 0, 1, 9
"d:\ROBLOX STUDIO\Rojo\UTP\src\ReplicatedStorage\Packages\_Index\evaera_cmdr@1.12.0\cmdr\Cmdr\BuiltInCommands\Admin\respawn.lua", "Lua", 0, 15, 0, 0, 0, 1, 16
"d:\ROBLOX STUDIO\Rojo\UTP\src\ReplicatedStorage\Packages\_Index\evaera_cmdr@1.12.0\cmdr\Cmdr\BuiltInCommands\Admin\respawnServer.lua", "Lua", 0, 8, 0, 0, 0, 1, 9
"d:\ROBLOX STUDIO\Rojo\UTP\src\ReplicatedStorage\Packages\_Index\evaera_cmdr@1.12.0\cmdr\Cmdr\BuiltInCommands\Admin\teleport.lua", "Lua", 0, 22, 0, 0, 0, 0, 22
"d:\ROBLOX STUDIO\Rojo\UTP\src\ReplicatedStorage\Packages\_Index\evaera_cmdr@1.12.0\cmdr\Cmdr\BuiltInCommands\Admin\teleportServer.lua", "Lua", 0, 18, 0, 0, 0, 4, 22
"d:\ROBLOX STUDIO\Rojo\UTP\src\ReplicatedStorage\Packages\_Index\evaera_cmdr@1.12.0\cmdr\Cmdr\BuiltInCommands\Debug\blink.lua", "Lua", 0, 16, 0, 0, 2, 5, 23
"d:\ROBLOX STUDIO\Rojo\UTP\src\ReplicatedStorage\Packages\_Index\evaera_cmdr@1.12.0\cmdr\Cmdr\BuiltInCommands\Debug\fetch.lua", "Lua", 0, 13, 0, 0, 0, 0, 13
"d:\ROBLOX STUDIO\Rojo\UTP\src\ReplicatedStorage\Packages\_Index\evaera_cmdr@1.12.0\cmdr\Cmdr\BuiltInCommands\Debug\fetchServer.lua", "Lua", 0, 4, 0, 0, 0, 1, 5
"d:\ROBLOX STUDIO\Rojo\UTP\src\ReplicatedStorage\Packages\_Index\evaera_cmdr@1.12.0\cmdr\Cmdr\BuiltInCommands\Debug\getPlayerPlaceInstance.lua", "Lua", 0, 21, 0, 0, 0, 0, 21
"d:\ROBLOX STUDIO\Rojo\UTP\src\ReplicatedStorage\Packages\_Index\evaera_cmdr@1.12.0\cmdr\Cmdr\BuiltInCommands\Debug\getPlayerPlaceInstanceServer.lua", "Lua", 0, 23, 0, 0, 0, 4, 27
"d:\ROBLOX STUDIO\Rojo\UTP\src\ReplicatedStorage\Packages\_Index\evaera_cmdr@1.12.0\cmdr\Cmdr\BuiltInCommands\Debug\position.lua", "Lua", 0, 22, 0, 0, 0, 4, 26
"d:\ROBLOX STUDIO\Rojo\UTP\src\ReplicatedStorage\Packages\_Index\evaera_cmdr@1.12.0\cmdr\Cmdr\BuiltInCommands\Debug\thru.lua", "Lua", 0, 25, 0, 0, 2, 6, 33
"d:\ROBLOX STUDIO\Rojo\UTP\src\ReplicatedStorage\Packages\_Index\evaera_cmdr@1.12.0\cmdr\Cmdr\BuiltInCommands\Debug\uptime.lua", "Lua", 0, 7, 0, 0, 0, 0, 7
"d:\ROBLOX STUDIO\Rojo\UTP\src\ReplicatedStorage\Packages\_Index\evaera_cmdr@1.12.0\cmdr\Cmdr\BuiltInCommands\Debug\uptimeServer.lua", "Lua", 0, 10, 0, 0, 0, 1, 11
"d:\ROBLOX STUDIO\Rojo\UTP\src\ReplicatedStorage\Packages\_Index\evaera_cmdr@1.12.0\cmdr\Cmdr\BuiltInCommands\Debug\version.lua", "Lua", 0, 10, 0, 0, 0, 3, 13
"d:\ROBLOX STUDIO\Rojo\UTP\src\ReplicatedStorage\Packages\_Index\evaera_cmdr@1.12.0\cmdr\Cmdr\BuiltInCommands\Utility\alias.lua", "Lua", 0, 25, 0, 0, 0, 2, 27
"d:\ROBLOX STUDIO\Rojo\UTP\src\ReplicatedStorage\Packages\_Index\evaera_cmdr@1.12.0\cmdr\Cmdr\BuiltInCommands\Utility\bind.lua", "Lua", 0, 56, 0, 0, 0, 9, 65
"d:\ROBLOX STUDIO\Rojo\UTP\src\ReplicatedStorage\Packages\_Index\evaera_cmdr@1.12.0\cmdr\Cmdr\BuiltInCommands\Utility\clear.lua", "Lua", 0, 21, 0, 0, 0, 3, 24
"d:\ROBLOX STUDIO\Rojo\UTP\src\ReplicatedStorage\Packages\_Index\evaera_cmdr@1.12.0\cmdr\Cmdr\BuiltInCommands\Utility\convertTimestamp.lua", "Lua", 0, 18, 0, 0, 0, 1, 19
"d:\ROBLOX STUDIO\Rojo\UTP\src\ReplicatedStorage\Packages\_Index\evaera_cmdr@1.12.0\cmdr\Cmdr\BuiltInCommands\Utility\echo.lua", "Lua", 0, 16, 0, 0, 0, 1, 17
"d:\ROBLOX STUDIO\Rojo\UTP\src\ReplicatedStorage\Packages\_Index\evaera_cmdr@1.12.0\cmdr\Cmdr\BuiltInCommands\Utility\edit.lua", "Lua", 0, 65, 0, 0, 0, 14, 79
"d:\ROBLOX STUDIO\Rojo\UTP\src\ReplicatedStorage\Packages\_Index\evaera_cmdr@1.12.0\cmdr\Cmdr\BuiltInCommands\Utility\history.lua", "Lua", 0, 25, 0, 0, 0, 3, 28
"d:\ROBLOX STUDIO\Rojo\UTP\src\ReplicatedStorage\Packages\_Index\evaera_cmdr@1.12.0\cmdr\Cmdr\BuiltInCommands\Utility\hover.lua", "Lua", 0, 16, 0, 0, 0, 5, 21
"d:\ROBLOX STUDIO\Rojo\UTP\src\ReplicatedStorage\Packages\_Index\evaera_cmdr@1.12.0\cmdr\Cmdr\BuiltInCommands\Utility\jsonArrayDecode.lua", "Lua", 0, 19, 0, 0, 0, 3, 22
"d:\ROBLOX STUDIO\Rojo\UTP\src\ReplicatedStorage\Packages\_Index\evaera_cmdr@1.12.0\cmdr\Cmdr\BuiltInCommands\Utility\jsonArrayEncode.lua", "Lua", 0, 17, 0, 0, 0, 2, 19
"d:\ROBLOX STUDIO\Rojo\UTP\src\ReplicatedStorage\Packages\_Index\evaera_cmdr@1.12.0\cmdr\Cmdr\BuiltInCommands\Utility\len.lua", "Lua", 0, 16, 0, 0, 0, 1, 17
"d:\ROBLOX STUDIO\Rojo\UTP\src\ReplicatedStorage\Packages\_Index\evaera_cmdr@1.12.0\cmdr\Cmdr\BuiltInCommands\Utility\math.lua", "Lua", 0, 34, 0, 0, 0, 2, 36
"d:\ROBLOX STUDIO\Rojo\UTP\src\ReplicatedStorage\Packages\_Index\evaera_cmdr@1.12.0\cmdr\Cmdr\BuiltInCommands\Utility\pick.lua", "Lua", 0, 21, 0, 0, 0, 1, 22
"d:\ROBLOX STUDIO\Rojo\UTP\src\ReplicatedStorage\Packages\_Index\evaera_cmdr@1.12.0\cmdr\Cmdr\BuiltInCommands\Utility\rand.lua", "Lua", 0, 22, 0, 0, 0, 1, 23
"d:\ROBLOX STUDIO\Rojo\UTP\src\ReplicatedStorage\Packages\_Index\evaera_cmdr@1.12.0\cmdr\Cmdr\BuiltInCommands\Utility\replace.lua", "Lua", 0, 31, 0, 0, 0, 1, 32
"d:\ROBLOX STUDIO\Rojo\UTP\src\ReplicatedStorage\Packages\_Index\evaera_cmdr@1.12.0\cmdr\Cmdr\BuiltInCommands\Utility\resolve.lua", "Lua", 0, 30, 0, 0, 0, 2, 32
"d:\ROBLOX STUDIO\Rojo\UTP\src\ReplicatedStorage\Packages\_Index\evaera_cmdr@1.12.0\cmdr\Cmdr\BuiltInCommands\Utility\run.lua", "Lua", 0, 19, 0, 0, 0, 1, 20
"d:\ROBLOX STUDIO\Rojo\UTP\src\ReplicatedStorage\Packages\_Index\evaera_cmdr@1.12.0\cmdr\Cmdr\BuiltInCommands\Utility\runLines.lua", "Lua", 0, 31, 0, 0, 0, 8, 39
"d:\ROBLOX STUDIO\Rojo\UTP\src\ReplicatedStorage\Packages\_Index\evaera_cmdr@1.12.0\cmdr\Cmdr\BuiltInCommands\Utility\runif.lua", "Lua", 0, 47, 0, 0, 0, 6, 53
"d:\ROBLOX STUDIO\Rojo\UTP\src\ReplicatedStorage\Packages\_Index\evaera_cmdr@1.12.0\cmdr\Cmdr\BuiltInCommands\Utility\unbind.lua", "Lua", 0, 23, 0, 0, 0, 2, 25
"d:\ROBLOX STUDIO\Rojo\UTP\src\ReplicatedStorage\Packages\_Index\evaera_cmdr@1.12.0\cmdr\Cmdr\BuiltInCommands\Utility\var.lua", "Lua", 0, 21, 0, 0, 0, 2, 23
"d:\ROBLOX STUDIO\Rojo\UTP\src\ReplicatedStorage\Packages\_Index\evaera_cmdr@1.12.0\cmdr\Cmdr\BuiltInCommands\Utility\varServer.lua", "Lua", 0, 48, 0, 0, 0, 13, 61
"d:\ROBLOX STUDIO\Rojo\UTP\src\ReplicatedStorage\Packages\_Index\evaera_cmdr@1.12.0\cmdr\Cmdr\BuiltInCommands\Utility\varSet.lua", "Lua", 0, 22, 0, 0, 0, 2, 24
"d:\ROBLOX STUDIO\Rojo\UTP\src\ReplicatedStorage\Packages\_Index\evaera_cmdr@1.12.0\cmdr\Cmdr\BuiltInCommands\Utility\varSetServer.lua", "Lua", 0, 48, 0, 0, 0, 16, 64
"d:\ROBLOX STUDIO\Rojo\UTP\src\ReplicatedStorage\Packages\_Index\evaera_cmdr@1.12.0\cmdr\Cmdr\BuiltInCommands\help.lua", "Lua", 0, 58, 0, 0, 2, 5, 65
"d:\ROBLOX STUDIO\Rojo\UTP\src\ReplicatedStorage\Packages\_Index\evaera_cmdr@1.12.0\cmdr\Cmdr\BuiltInTypes\BindableResource.lua", "Lua", 0, 3, 0, 0, 0, 1, 4
"d:\ROBLOX STUDIO\Rojo\UTP\src\ReplicatedStorage\Packages\_Index\evaera_cmdr@1.12.0\cmdr\Cmdr\BuiltInTypes\BrickColor.lua", "Lua", 0, 68, 0, 0, 0, 11, 79
"d:\ROBLOX STUDIO\Rojo\UTP\src\ReplicatedStorage\Packages\_Index\evaera_cmdr@1.12.0\cmdr\Cmdr\BuiltInTypes\Color3.lua", "Lua", 0, 43, 0, 0, 0, 10, 53
"d:\ROBLOX STUDIO\Rojo\UTP\src\ReplicatedStorage\Packages\_Index\evaera_cmdr@1.12.0\cmdr\Cmdr\BuiltInTypes\Command.lua", "Lua", 0, 20, 0, 0, 0, 6, 26
"d:\ROBLOX STUDIO\Rojo\UTP\src\ReplicatedStorage\Packages\_Index\evaera_cmdr@1.12.0\cmdr\Cmdr\BuiltInTypes\ConditionFunction.lua", "Lua", 0, 3, 0, 0, 0, 1, 4
"d:\ROBLOX STUDIO\Rojo\UTP\src\ReplicatedStorage\Packages\_Index\evaera_cmdr@1.12.0\cmdr\Cmdr\BuiltInTypes\Duration.lua", "Lua", 0, 90, 0, 0, 13, 10, 113
"d:\ROBLOX STUDIO\Rojo\UTP\src\ReplicatedStorage\Packages\_Index\evaera_cmdr@1.12.0\cmdr\Cmdr\BuiltInTypes\JSON.lua", "Lua", 0, 11, 0, 0, 0, 3, 14
"d:\ROBLOX STUDIO\Rojo\UTP\src\ReplicatedStorage\Packages\_Index\evaera_cmdr@1.12.0\cmdr\Cmdr\BuiltInTypes\MathOperator.lua", "Lua", 0, 40, 0, 0, 0, 1, 41
"d:\ROBLOX STUDIO\Rojo\UTP\src\ReplicatedStorage\Packages\_Index\evaera_cmdr@1.12.0\cmdr\Cmdr\BuiltInTypes\Player.lua", "Lua", 0, 32, 0, 0, 0, 9, 41
"d:\ROBLOX STUDIO\Rojo\UTP\src\ReplicatedStorage\Packages\_Index\evaera_cmdr@1.12.0\cmdr\Cmdr\BuiltInTypes\PlayerId.lua", "Lua", 0, 50, 0, 0, 0, 13, 63
"d:\ROBLOX STUDIO\Rojo\UTP\src\ReplicatedStorage\Packages\_Index\evaera_cmdr@1.12.0\cmdr\Cmdr\BuiltInTypes\Primitives.lua", "Lua", 0, 114, 0, 0, 0, 27, 141
"d:\ROBLOX STUDIO\Rojo\UTP\src\ReplicatedStorage\Packages\_Index\evaera_cmdr@1.12.0\cmdr\Cmdr\BuiltInTypes\StoredKey.lua", "Lua", 0, 28, 0, 0, 0, 7, 35
"d:\ROBLOX STUDIO\Rojo\UTP\src\ReplicatedStorage\Packages\_Index\evaera_cmdr@1.12.0\cmdr\Cmdr\BuiltInTypes\Team.lua", "Lua", 0, 41, 0, 0, 0, 12, 53
"d:\ROBLOX STUDIO\Rojo\UTP\src\ReplicatedStorage\Packages\_Index\evaera_cmdr@1.12.0\cmdr\Cmdr\BuiltInTypes\Type.lua", "Lua", 0, 20, 0, 0, 0, 6, 26
"d:\ROBLOX STUDIO\Rojo\UTP\src\ReplicatedStorage\Packages\_Index\evaera_cmdr@1.12.0\cmdr\Cmdr\BuiltInTypes\URL.lua", "Lua", 0, 16, 0, 0, 0, 5, 21
"d:\ROBLOX STUDIO\Rojo\UTP\src\ReplicatedStorage\Packages\_Index\evaera_cmdr@1.12.0\cmdr\Cmdr\BuiltInTypes\UserInput.lua", "Lua", 0, 24, 0, 0, 0, 8, 32
"d:\ROBLOX STUDIO\Rojo\UTP\src\ReplicatedStorage\Packages\_Index\evaera_cmdr@1.12.0\cmdr\Cmdr\BuiltInTypes\Vector.lua", "Lua", 0, 25, 0, 0, 0, 6, 31
"d:\ROBLOX STUDIO\Rojo\UTP\src\ReplicatedStorage\Packages\_Index\evaera_cmdr@1.12.0\cmdr\Cmdr\CmdrClient\CmdrInterface\AutoComplete.lua", "Lua", 0, 149, 0, 0, 27, 41, 217
"d:\ROBLOX STUDIO\Rojo\UTP\src\ReplicatedStorage\Packages\_Index\evaera_cmdr@1.12.0\cmdr\Cmdr\CmdrClient\CmdrInterface\Window.lua", "Lua", 0, 256, 0, 0, 23, 58, 337
"d:\ROBLOX STUDIO\Rojo\UTP\src\ReplicatedStorage\Packages\_Index\evaera_cmdr@1.12.0\cmdr\Cmdr\CmdrClient\CmdrInterface\init.lua", "Lua", 0, 117, 0, 0, 3, 32, 152
"d:\ROBLOX STUDIO\Rojo\UTP\src\ReplicatedStorage\Packages\_Index\evaera_cmdr@1.12.0\cmdr\Cmdr\CmdrClient\DefaultEventHandlers.lua", "Lua", 0, 13, 0, 0, 0, 2, 15
"d:\ROBLOX STUDIO\Rojo\UTP\src\ReplicatedStorage\Packages\_Index\evaera_cmdr@1.12.0\cmdr\Cmdr\CmdrClient\init.lua", "Lua", 0, 90, 0, 0, 14, 23, 127
"d:\ROBLOX STUDIO\Rojo\UTP\src\ReplicatedStorage\Packages\_Index\evaera_cmdr@1.12.0\cmdr\Cmdr\CreateGui.lua", "Lua", 0, 195, 0, 0, 0, 23, 218
"d:\ROBLOX STUDIO\Rojo\UTP\src\ReplicatedStorage\Packages\_Index\evaera_cmdr@1.12.0\cmdr\Cmdr\Initialize.lua", "Lua", 0, 28, 0, 0, 1, 12, 41
"d:\ROBLOX STUDIO\Rojo\UTP\src\ReplicatedStorage\Packages\_Index\evaera_cmdr@1.12.0\cmdr\Cmdr\Shared\Argument.lua", "Lua", 0, 196, 0, 0, 8, 54, 258
"d:\ROBLOX STUDIO\Rojo\UTP\src\ReplicatedStorage\Packages\_Index\evaera_cmdr@1.12.0\cmdr\Cmdr\Shared\Command.lua", "Lua", 0, 160, 0, 0, 22, 41, 223
"d:\ROBLOX STUDIO\Rojo\UTP\src\ReplicatedStorage\Packages\_Index\evaera_cmdr@1.12.0\cmdr\Cmdr\Shared\Dispatcher.lua", "Lua", 0, 135, 0, 0, 15, 40, 190
"d:\ROBLOX STUDIO\Rojo\UTP\src\ReplicatedStorage\Packages\_Index\evaera_cmdr@1.12.0\cmdr\Cmdr\Shared\Registry.lua", "Lua", 0, 213, 0, 0, 24, 58, 295
"d:\ROBLOX STUDIO\Rojo\UTP\src\ReplicatedStorage\Packages\_Index\evaera_cmdr@1.12.0\cmdr\Cmdr\Shared\Util.lua", "Lua", 0, 423, 0, 0, 35, 91, 549
"d:\ROBLOX STUDIO\Rojo\UTP\src\ReplicatedStorage\Packages\_Index\evaera_cmdr@1.12.0\cmdr\Cmdr\init.lua", "Lua", 0, 33, 0, 0, 1, 7, 41
"d:\ROBLOX STUDIO\Rojo\UTP\src\ReplicatedStorage\Packages\_Index\evaera_cmdr@1.12.0\cmdr\README.md", "Markdown", 0, 0, 17, 0, 0, 6, 23
"d:\ROBLOX STUDIO\Rojo\UTP\src\ReplicatedStorage\Packages\_Index\evaera_cmdr@1.12.0\cmdr\default.project.json", "JSON", 6, 0, 0, 0, 0, 0, 6
"d:\ROBLOX STUDIO\Rojo\UTP\src\ReplicatedStorage\Packages\_Index\evaera_cmdr@1.12.0\cmdr\test-place.project.json", "JSON", 12, 0, 0, 0, 0, 2, 14
"d:\ROBLOX STUDIO\Rojo\UTP\src\ReplicatedStorage\Packages\_Index\ffrostflame_bridgenet2@0.5.6\RemotePacketSizeCounter.lua", "Lua", 0, 1, 0, 0, 0, 1, 2
"d:\ROBLOX STUDIO\Rojo\UTP\src\ReplicatedStorage\Packages\_Index\ffrostflame_bridgenet2@0.5.6\TableKit.lua", "Lua", 0, 1, 0, 0, 0, 1, 2
"d:\ROBLOX STUDIO\Rojo\UTP\src\ReplicatedStorage\Packages\_Index\ffrostflame_bridgenet2@0.5.6\bridgenet2\CHANGELOG.md", "Markdown", 0, 0, 94, 0, 0, 61, 155
"d:\ROBLOX STUDIO\Rojo\UTP\src\ReplicatedStorage\Packages\_Index\ffrostflame_bridgenet2@0.5.6\bridgenet2\CONTRIBUTORS.md", "Markdown", 0, 0, 15, 0, 0, 9, 24
"d:\ROBLOX STUDIO\Rojo\UTP\src\ReplicatedStorage\Packages\_Index\ffrostflame_bridgenet2@0.5.6\bridgenet2\README.md", "Markdown", 0, 0, 10, 0, 0, 9, 19
"d:\ROBLOX STUDIO\Rojo\UTP\src\ReplicatedStorage\Packages\_Index\ffrostflame_bridgenet2@0.5.6\bridgenet2\benchmarks\Hex.bench.luau", "Lua", 0, 23, 0, 0, 2, 8, 33
"d:\ROBLOX STUDIO\Rojo\UTP\src\ReplicatedStorage\Packages\_Index\ffrostflame_bridgenet2@0.5.6\bridgenet2\default.project.json", "JSON", 6, 0, 0, 0, 0, 0, 6
"d:\ROBLOX STUDIO\Rojo\UTP\src\ReplicatedStorage\Packages\_Index\ffrostflame_bridgenet2@0.5.6\bridgenet2\docs\Installation.md", "Markdown", 0, 0, 12, 0, 0, 7, 19
"d:\ROBLOX STUDIO\Rojo\UTP\src\ReplicatedStorage\Packages\_Index\ffrostflame_bridgenet2@0.5.6\bridgenet2\docs\Technical Details\Identifiers.md", "Markdown", 0, 0, 22, 0, 0, 8, 30
"d:\ROBLOX STUDIO\Rojo\UTP\src\ReplicatedStorage\Packages\_Index\ffrostflame_bridgenet2@0.5.6\bridgenet2\docs\Technical Details\_category_.json", "JSON", 4, 0, 0, 0, 0, 0, 4
"d:\ROBLOX STUDIO\Rojo\UTP\src\ReplicatedStorage\Packages\_Index\ffrostflame_bridgenet2@0.5.6\bridgenet2\docs\Tutorials\Best Practices.md", "Markdown", 0, 0, 4, 0, 0, 1, 5
"d:\ROBLOX STUDIO\Rojo\UTP\src\ReplicatedStorage\Packages\_Index\ffrostflame_bridgenet2@0.5.6\bridgenet2\docs\Tutorials\Getting Started.md", "Markdown", 0, 0, 88, 0, 0, 28, 116
"d:\ROBLOX STUDIO\Rojo\UTP\src\ReplicatedStorage\Packages\_Index\ffrostflame_bridgenet2@0.5.6\bridgenet2\docs\Tutorials\Logging.md", "Markdown", 0, 0, 10, 0, 0, 7, 17
"d:\ROBLOX STUDIO\Rojo\UTP\src\ReplicatedStorage\Packages\_Index\ffrostflame_bridgenet2@0.5.6\bridgenet2\docs\Tutorials\Using Identifiers.md", "Markdown", 0, 0, 29, 0, 0, 10, 39
"d:\ROBLOX STUDIO\Rojo\UTP\src\ReplicatedStorage\Packages\_Index\ffrostflame_bridgenet2@0.5.6\bridgenet2\docs\Tutorials\_category_.json", "JSON", 4, 0, 0, 0, 0, 0, 4
"d:\ROBLOX STUDIO\Rojo\UTP\src\ReplicatedStorage\Packages\_Index\ffrostflame_bridgenet2@0.5.6\bridgenet2\docs\intro.md", "Markdown", 0, 0, 9, 0, 0, 7, 16
"d:\ROBLOX STUDIO\Rojo\UTP\src\ReplicatedStorage\Packages\_Index\ffrostflame_bridgenet2@0.5.6\bridgenet2\package-lock.json", "JSON", 5028, 0, 0, 0, 0, 1, 5029
"d:\ROBLOX STUDIO\Rojo\UTP\src\ReplicatedStorage\Packages\_Index\ffrostflame_bridgenet2@0.5.6\bridgenet2\package.json", "JSON", 36, 0, 0, 0, 0, 1, 37
"d:\ROBLOX STUDIO\Rojo\UTP\src\ReplicatedStorage\Packages\_Index\ffrostflame_bridgenet2@0.5.6\bridgenet2\release.js", "JavaScript", 0, 0, 0, 158, 1, 18, 177
"d:\ROBLOX STUDIO\Rojo\UTP\src\ReplicatedStorage\Packages\_Index\ffrostflame_bridgenet2@0.5.6\bridgenet2\src\Client\ClientBridge.luau", "Lua", 0, 234, 0, 0, 18, 49, 301
"d:\ROBLOX STUDIO\Rojo\UTP\src\ReplicatedStorage\Packages\_Index\ffrostflame_bridgenet2@0.5.6\bridgenet2\src\Client\ClientConnection.luau", "Lua", 0, 21, 0, 0, 0, 12, 33
"d:\ROBLOX STUDIO\Rojo\UTP\src\ReplicatedStorage\Packages\_Index\ffrostflame_bridgenet2@0.5.6\bridgenet2\src\Client\ClientIdentifiers.luau", "Lua", 0, 90, 0, 0, 14, 27, 131
"d:\ROBLOX STUDIO\Rojo\UTP\src\ReplicatedStorage\Packages\_Index\ffrostflame_bridgenet2@0.5.6\bridgenet2\src\Client\ClientProcess.luau", "Lua", 0, 79, 0, 0, 14, 20, 113
"d:\ROBLOX STUDIO\Rojo\UTP\src\ReplicatedStorage\Packages\_Index\ffrostflame_bridgenet2@0.5.6\bridgenet2\src\Client\init.luau", "Lua", 0, 42, 0, 0, 1, 15, 58
"d:\ROBLOX STUDIO\Rojo\UTP\src\ReplicatedStorage\Packages\_Index\ffrostflame_bridgenet2@0.5.6\bridgenet2\src\Constants.luau", "Lua", 0, 9, 0, 0, 1, 4, 14
"d:\ROBLOX STUDIO\Rojo\UTP\src\ReplicatedStorage\Packages\_Index\ffrostflame_bridgenet2@0.5.6\bridgenet2\src\PublicTypes.luau", "Lua", 0, 47, 0, 0, 1, 16, 64
"d:\ROBLOX STUDIO\Rojo\UTP\src\ReplicatedStorage\Packages\_Index\ffrostflame_bridgenet2@0.5.6\bridgenet2\src\Server\HandleInvalidPlayer.luau", "Lua", 0, 6, 0, 0, 2, 3, 11
"d:\ROBLOX STUDIO\Rojo\UTP\src\ReplicatedStorage\Packages\_Index\ffrostflame_bridgenet2@0.5.6\bridgenet2\src\Server\PlayerContainers\All.luau", "Lua", 0, 8, 0, 0, 3, 5, 16
"d:\ROBLOX STUDIO\Rojo\UTP\src\ReplicatedStorage\Packages\_Index\ffrostflame_bridgenet2@0.5.6\bridgenet2\src\Server\PlayerContainers\Except.luau", "Lua", 0, 6, 0, 0, 1, 3, 10
"d:\ROBLOX STUDIO\Rojo\UTP\src\ReplicatedStorage\Packages\_Index\ffrostflame_bridgenet2@0.5.6\bridgenet2\src\Server\PlayerContainers\Players.luau", "Lua", 0, 6, 0, 0, 1, 3, 10
"d:\ROBLOX STUDIO\Rojo\UTP\src\ReplicatedStorage\Packages\_Index\ffrostflame_bridgenet2@0.5.6\bridgenet2\src\Server\PlayerContainers\Single.luau", "Lua", 0, 6, 0, 0, 1, 3, 10
"d:\ROBLOX STUDIO\Rojo\UTP\src\ReplicatedStorage\Packages\_Index\ffrostflame_bridgenet2@0.5.6\bridgenet2\src\Server\PlayerContainers\init.luau", "Lua", 0, 7, 0, 0, 1, 2, 10
"d:\ROBLOX STUDIO\Rojo\UTP\src\ReplicatedStorage\Packages\_Index\ffrostflame_bridgenet2@0.5.6\bridgenet2\src\Server\ServerBridge.luau", "Lua", 0, 267, 0, 0, 17, 49, 333
"d:\ROBLOX STUDIO\Rojo\UTP\src\ReplicatedStorage\Packages\_Index\ffrostflame_bridgenet2@0.5.6\bridgenet2\src\Server\ServerConnection.luau", "Lua", 0, 21, 0, 0, 1, 12, 34
"d:\ROBLOX STUDIO\Rojo\UTP\src\ReplicatedStorage\Packages\_Index\ffrostflame_bridgenet2@0.5.6\bridgenet2\src\Server\ServerIdentifiers.luau", "Lua", 0, 53, 0, 0, 2, 14, 69
"d:\ROBLOX STUDIO\Rojo\UTP\src\ReplicatedStorage\Packages\_Index\ffrostflame_bridgenet2@0.5.6\bridgenet2\src\Server\ServerProcess.luau", "Lua", 0, 188, 0, 0, 30, 46, 264
"d:\ROBLOX STUDIO\Rojo\UTP\src\ReplicatedStorage\Packages\_Index\ffrostflame_bridgenet2@0.5.6\bridgenet2\src\Server\init.luau", "Lua", 0, 40, 0, 0, 1, 14, 55
"d:\ROBLOX STUDIO\Rojo\UTP\src\ReplicatedStorage\Packages\_Index\ffrostflame_bridgenet2@0.5.6\bridgenet2\src\Studio\MockBridge.luau", "Lua", 0, 84, 0, 0, 3, 24, 111
"d:\ROBLOX STUDIO\Rojo\UTP\src\ReplicatedStorage\Packages\_Index\ffrostflame_bridgenet2@0.5.6\bridgenet2\src\Studio\MockConnection.luau", "Lua", 0, 18, 0, 0, 0, 9, 27
"d:\ROBLOX STUDIO\Rojo\UTP\src\ReplicatedStorage\Packages\_Index\ffrostflame_bridgenet2@0.5.6\bridgenet2\src\Studio\MockIdentifiers.luau", "Lua", 0, 0, 0, 0, 0, 1, 1
"d:\ROBLOX STUDIO\Rojo\UTP\src\ReplicatedStorage\Packages\_Index\ffrostflame_bridgenet2@0.5.6\bridgenet2\src\Types.luau", "Lua", 0, 39, 0, 0, 2, 12, 53
"d:\ROBLOX STUDIO\Rojo\UTP\src\ReplicatedStorage\Packages\_Index\ffrostflame_bridgenet2@0.5.6\bridgenet2\src\Utilities\NetworkUtils.luau", "Lua", 0, 22, 0, 0, 5, 8, 35
"d:\ROBLOX STUDIO\Rojo\UTP\src\ReplicatedStorage\Packages\_Index\ffrostflame_bridgenet2@0.5.6\bridgenet2\src\Utilities\Output.luau", "Lua", 0, 48, 0, 0, 4, 18, 70
"d:\ROBLOX STUDIO\Rojo\UTP\src\ReplicatedStorage\Packages\_Index\ffrostflame_bridgenet2@0.5.6\bridgenet2\src\Utilities\RecycledSpawn.luau", "Lua", 0, 19, 0, 0, 0, 4, 23
"d:\ROBLOX STUDIO\Rojo\UTP\src\ReplicatedStorage\Packages\_Index\ffrostflame_bridgenet2@0.5.6\bridgenet2\src\Utilities\isEditMode.luau", "Lua", 0, 2, 0, 0, 0, 2, 4
"d:\ROBLOX STUDIO\Rojo\UTP\src\ReplicatedStorage\Packages\_Index\ffrostflame_bridgenet2@0.5.6\bridgenet2\src\Utilities\tostringData.luau", "Lua", 0, 21, 0, 0, 1, 2, 24
"d:\ROBLOX STUDIO\Rojo\UTP\src\ReplicatedStorage\Packages\_Index\ffrostflame_bridgenet2@0.5.6\bridgenet2\src\init.luau", "Lua", 0, 95, 0, 0, 13, 31, 139
"d:\ROBLOX STUDIO\Rojo\UTP\src\ReplicatedStorage\Packages\_Index\ffrostflame_bridgenet2@0.5.6\bridgenet2\src\version.luau", "Lua", 0, 1, 0, 0, 0, 1, 2
"d:\ROBLOX STUDIO\Rojo\UTP\src\ReplicatedStorage\Packages\_Index\ffrostflame_bridgenet2@0.5.6\bridgenet2\standalone.js", "JavaScript", 0, 0, 0, 45, 0, 6, 51
"d:\ROBLOX STUDIO\Rojo\UTP\src\ReplicatedStorage\Packages\_Index\ffrostflame_bridgenet2@0.5.6\bridgenet2\stresstest.project.json", "JSON", 33, 0, 0, 0, 0, 0, 33
"d:\ROBLOX STUDIO\Rojo\UTP\src\ReplicatedStorage\Packages\_Index\ffrostflame_bridgenet2@0.5.6\bridgenet2\style-guide.md", "Markdown", 0, 0, 6, 0, 0, 4, 10
"d:\ROBLOX STUDIO\Rojo\UTP\src\ReplicatedStorage\Packages\_Index\ffrostflame_bridgenet2@0.5.6\bridgenet2\testing.project.json", "JSON", 29, 0, 0, 0, 0, 0, 29
"d:\ROBLOX STUDIO\Rojo\UTP\src\ReplicatedStorage\Packages\_Index\ffrostflame_bridgenet2@0.5.6\bridgenet2\testing\framework\bootstrapper.luau", "Lua", 0, 95, 0, 0, 1, 28, 124
"d:\ROBLOX STUDIO\Rojo\UTP\src\ReplicatedStorage\Packages\_Index\ffrostflame_bridgenet2@0.5.6\bridgenet2\testing\framework\expect.luau", "Lua", 0, 132, 0, 0, 2, 30, 164
"d:\ROBLOX STUDIO\Rojo\UTP\src\ReplicatedStorage\Packages\_Index\ffrostflame_bridgenet2@0.5.6\bridgenet2\testing\framework\init.luau", "Lua", 0, 6, 0, 0, 0, 2, 8
"d:\ROBLOX STUDIO\Rojo\UTP\src\ReplicatedStorage\Packages\_Index\ffrostflame_bridgenet2@0.5.6\bridgenet2\testing\stress\client\init.client.luau", "Lua", 0, 16, 0, 0, 0, 6, 22
"d:\ROBLOX STUDIO\Rojo\UTP\src\ReplicatedStorage\Packages\_Index\ffrostflame_bridgenet2@0.5.6\bridgenet2\testing\stress\server\init.server.luau", "Lua", 0, 22, 0, 0, 0, 7, 29
"d:\ROBLOX STUDIO\Rojo\UTP\src\ReplicatedStorage\Packages\_Index\ffrostflame_bridgenet2@0.5.6\bridgenet2\testing\tests\client\featureTests\init.client.luau", "Lua", 0, 15, 0, 0, 0, 7, 22
"d:\ROBLOX STUDIO\Rojo\UTP\src\ReplicatedStorage\Packages\_Index\ffrostflame_bridgenet2@0.5.6\bridgenet2\testing\tests\server\featureTests\init.server.luau", "Lua", 0, 34, 0, 0, 2, 13, 49
"d:\ROBLOX STUDIO\Rojo\UTP\src\ReplicatedStorage\Packages\_Index\ffrostflame_bridgenet2@0.5.6\wallyInstanceManager.lua", "Lua", 0, 1, 0, 0, 0, 1, 2
"d:\ROBLOX STUDIO\Rojo\UTP\src\ReplicatedStorage\Packages\_Index\ffrostflame_tablekit@0.2.4\tablekit\CHANGELOG.md", "Markdown", 0, 0, 17, 0, 0, 12, 29
"d:\ROBLOX STUDIO\Rojo\UTP\src\ReplicatedStorage\Packages\_Index\ffrostflame_tablekit@0.2.4\tablekit\README.md", "Markdown", 0, 0, 18, 0, 0, 6, 24
"d:\ROBLOX STUDIO\Rojo\UTP\src\ReplicatedStorage\Packages\_Index\ffrostflame_tablekit@0.2.4\tablekit\default.project.json", "JSON", 6, 0, 0, 0, 0, 0, 6
"d:\ROBLOX STUDIO\Rojo\UTP\src\ReplicatedStorage\Packages\_Index\ffrostflame_tablekit@0.2.4\tablekit\docs\Installation.md", "Markdown", 0, 0, 14, 0, 0, 5, 19
"d:\ROBLOX STUDIO\Rojo\UTP\src\ReplicatedStorage\Packages\_Index\ffrostflame_tablekit@0.2.4\tablekit\docs\intro.md", "Markdown", 0, 0, 16, 0, 0, 4, 20
"d:\ROBLOX STUDIO\Rojo\UTP\src\ReplicatedStorage\Packages\_Index\ffrostflame_tablekit@0.2.4\tablekit\package-lock.json", "JSON", 1871, 0, 0, 0, 0, 1, 1872
"d:\ROBLOX STUDIO\Rojo\UTP\src\ReplicatedStorage\Packages\_Index\ffrostflame_tablekit@0.2.4\tablekit\package.json", "JSON", 5, 0, 0, 0, 0, 1, 6
"d:\ROBLOX STUDIO\Rojo\UTP\src\ReplicatedStorage\Packages\_Index\ffrostflame_tablekit@0.2.4\tablekit\src\init.luau", "Lua", 0, 400, 0, 0, 22, 89, 511
"d:\ROBLOX STUDIO\Rojo\UTP\src\ReplicatedStorage\Packages\_Index\ffrostflame_tablekit@0.2.4\tablekit\testing.project.json", "JSON", 17, 0, 0, 0, 0, 0, 17
"d:\ROBLOX STUDIO\Rojo\UTP\src\ReplicatedStorage\Packages\_Index\ffrostflame_tablekit@0.2.4\tablekit\tests\init.client.luau", "Lua", 0, 98, 0, 0, 1, 11, 110
"d:\ROBLOX STUDIO\Rojo\UTP\src\ReplicatedStorage\Packages\_Index\ffrostflame_wally-instance-manager@0.1.0\wally-instance-manager\README.md", "Markdown", 0, 0, 13, 0, 0, 7, 20
"d:\ROBLOX STUDIO\Rojo\UTP\src\ReplicatedStorage\Packages\_Index\ffrostflame_wally-instance-manager@0.1.0\wally-instance-manager\default.project.json", "JSON", 6, 0, 0, 0, 0, 0, 6
"d:\ROBLOX STUDIO\Rojo\UTP\src\ReplicatedStorage\Packages\_Index\ffrostflame_wally-instance-manager@0.1.0\wally-instance-manager\src\init.luau", "Lua", 0, 20, 0, 0, 0, 8, 28
"d:\ROBLOX STUDIO\Rojo\UTP\src\ReplicatedStorage\Packages\_Index\pysephwasntavailable_remotepacketsizecounter@2.3.1\remotepacketsizecounter\default.project.json", "JSON", 6, 0, 0, 0, 0, 0, 6
"d:\ROBLOX STUDIO\Rojo\UTP\src\ReplicatedStorage\Packages\_Index\pysephwasntavailable_remotepacketsizecounter@2.3.1\remotepacketsizecounter\src\init.luau", "Lua", 0, 132, 0, 0, 39, 28, 199
"d:\ROBLOX STUDIO\Rojo\UTP\src\ReplicatedStorage\Packages\_Index\untakeranonplay_simplepath@0.1.1\simplepath\default.project.json", "JSON", 6, 0, 0, 0, 0, 0, 6
"d:\ROBLOX STUDIO\Rojo\UTP\src\ReplicatedStorage\Packages\_Index\untakeranonplay_simplepath@0.1.1\simplepath\src\ReplicatedStorage\SimplePath\init.lua", "Lua", 0, 271, 0, 0, 34, 45, 350
"d:\ROBLOX STUDIO\Rojo\UTP\src\ReplicatedStorage\Packages\bridgenet2.lua", "Lua", 0, 1, 0, 0, 0, 1, 2
"d:\ROBLOX STUDIO\Rojo\UTP\src\ReplicatedStorage\Packages\cmdr.lua", "Lua", 0, 1, 0, 0, 0, 1, 2
"d:\ROBLOX STUDIO\Rojo\UTP\src\ReplicatedStorage\Packages\simplepath.lua", "Lua", 0, 1, 0, 0, 0, 1, 2
"d:\ROBLOX STUDIO\Rojo\UTP\src\ReplicatedStorage\PersonModels\Astra\Animator.server.lua", "Lua", 0, 17, 0, 0, 0, 2, 19
"d:\ROBLOX STUDIO\Rojo\UTP\src\ReplicatedStorage\PersonModels\Astra\init.meta.json", "JSON", 4, 0, 0, 0, 0, 0, 4
"d:\ROBLOX STUDIO\Rojo\UTP\src\ReplicatedStorage\PersonModels\Saske\Animate.client.lua", "Lua", 0, 0, 0, 0, 0, 1, 1
"d:\ROBLOX STUDIO\Rojo\UTP\src\ReplicatedStorage\PersonModels\Saske\Animate.meta.json", "JSON", 3, 0, 0, 0, 0, 0, 3
"d:\ROBLOX STUDIO\Rojo\UTP\src\ReplicatedStorage\PersonModels\Saske\Animate.server.lua", "Lua", 0, 0, 0, 0, 0, 1, 1
"d:\ROBLOX STUDIO\Rojo\UTP\src\ReplicatedStorage\PersonModels\Saske\Health.server.lua", "Lua", 0, 12, 0, 0, 3, 5, 20
"d:\ROBLOX STUDIO\Rojo\UTP\src\ReplicatedStorage\PersonModels\Saske\Sound\LocalSound.client.lua", "Lua", 0, 344, 0, 0, 23, 61, 428
"d:\ROBLOX STUDIO\Rojo\UTP\src\ReplicatedStorage\PersonModels\Saske\Sound\init.server.lua", "Lua", 0, 0, 0, 0, 0, 1, 1
"d:\ROBLOX STUDIO\Rojo\UTP\src\ReplicatedStorage\PersonModels\Saske\init.meta.json", "JSON", 4, 0, 0, 0, 0, 0, 4
"d:\ROBLOX STUDIO\Rojo\UTP\src\ReplicatedStorage\PersonModels\init.meta.json", "JSON", 3, 0, 0, 0, 0, 0, 3
"d:\ROBLOX STUDIO\Rojo\UTP\src\ReplicatedStorage\PowersData.lua", "Lua", 0, 64, 0, 0, 5, 25, 94
"d:\ROBLOX STUDIO\Rojo\UTP\src\ReplicatedStorage\TweenSequenceIncludes\Animator.lua", "Lua", 0, 28, 0, 0, 1, 9, 38
"d:\ROBLOX STUDIO\Rojo\UTP\src\ReplicatedStorage\TweenSequenceIncludes\AnimatorInterface.lua", "Lua", 0, 1, 0, 0, 1, 1, 3
"d:\ROBLOX STUDIO\Rojo\UTP\src\ReplicatedStorage\TweenSequenceIncludes\README.server.lua", "Lua", 0, 6, 0, 0, 2, 1, 9
"d:\ROBLOX STUDIO\Rojo\UTP\src\ReplicatedStorage\TweenSequenceIncludes\Track.lua", "Lua", 0, 68, 0, 0, 0, 10, 78
"d:\ROBLOX STUDIO\Rojo\UTP\src\ReplicatedStorage\TweenSequenceIncludes\TweenUtilities.lua", "Lua", 0, 255, 0, 0, 1, 36, 292
"d:\ROBLOX STUDIO\Rojo\UTP\src\ReplicatedStorage\TweenSequenceIncludes\createSignal.lua", "Lua", 0, 53, 0, 0, 1, 17, 71
"d:\ROBLOX STUDIO\Rojo\UTP\src\ReplicatedStorage\TweenSequenceIncludes\init.meta.json", "JSON", 3, 0, 0, 0, 0, 0, 3
"d:\ROBLOX STUDIO\Rojo\UTP\src\ReplicatedStorage\TycoonModel\MainItems\ConveyorBelt\CollectorPart\CollectScript.server.lua", "Lua", 0, 10, 0, 0, 0, 4, 14
"d:\ROBLOX STUDIO\Rojo\UTP\src\ReplicatedStorage\TycoonModel\MainItems\ConveyorBelt\CollectorPart\init.meta.json", "JSON", 4, 0, 0, 0, 0, 0, 4
"d:\ROBLOX STUDIO\Rojo\UTP\src\ReplicatedStorage\TycoonModel\MainItems\ConveyorBelt\ConveyorPart1\Script.server.lua", "Lua", 0, 4, 0, 0, 0, 2, 6
"d:\ROBLOX STUDIO\Rojo\UTP\src\ReplicatedStorage\TycoonModel\MainItems\ConveyorBelt\ConveyorPart1\init.meta.json", "JSON", 4, 0, 0, 0, 0, 0, 4
"d:\ROBLOX STUDIO\Rojo\UTP\src\ReplicatedStorage\TycoonModel\MainItems\ConveyorBelt\ConveyorPart2\Script.server.lua", "Lua", 0, 4, 0, 0, 0, 2, 6
"d:\ROBLOX STUDIO\Rojo\UTP\src\ReplicatedStorage\TycoonModel\MainItems\ConveyorBelt\ConveyorPart2\init.meta.json", "JSON", 4, 0, 0, 0, 0, 0, 4
"d:\ROBLOX STUDIO\Rojo\UTP\src\ReplicatedStorage\TycoonModel\MainItems\ConveyorBelt\init.meta.json", "JSON", 4, 0, 0, 0, 0, 0, 4
"d:\ROBLOX STUDIO\Rojo\UTP\src\ReplicatedStorage\TycoonModel\MainItems\OwnerDoor\MainDoor\OwnerScript.server.lua", "Lua", 0, 18, 0, 0, 2, 10, 30
"d:\ROBLOX STUDIO\Rojo\UTP\src\ReplicatedStorage\TycoonModel\MainItems\OwnerDoor\MainDoor\init.meta.json", "JSON", 4, 0, 0, 0, 0, 0, 4
"d:\ROBLOX STUDIO\Rojo\UTP\src\ReplicatedStorage\TycoonModel\MainItems\OwnerDoor\init.meta.json", "JSON", 4, 0, 0, 0, 0, 0, 4
"d:\ROBLOX STUDIO\Rojo\UTP\src\ReplicatedStorage\TycoonModel\MainItems\init.meta.json", "JSON", 3, 0, 0, 0, 0, 0, 3
"d:\ROBLOX STUDIO\Rojo\UTP\src\ReplicatedStorage\TycoonModel\init.meta.json", "JSON", 4, 0, 0, 0, 0, 0, 4
"d:\ROBLOX STUDIO\Rojo\UTP\src\ReplicatedStorage\teste.lua", "Lua", 0, 9, 0, 0, 0, 15, 24
"d:\ROBLOX STUDIO\Rojo\UTP\src\ServerScriptService\GameServices.server.lua", "Lua", 0, 51, 0, 0, 12, 54, 117
"d:\ROBLOX STUDIO\Rojo\UTP\src\ServerScriptService\PlayerConnectionService.server.lua", "Lua", 0, 37, 0, 0, 8, 16, 61
"d:\ROBLOX STUDIO\Rojo\UTP\src\ServerScriptService\leaderStats.server.lua", "Lua", 0, 18, 0, 0, 0, 13, 31
"d:\ROBLOX STUDIO\Rojo\UTP\src\ServerStorage\Services\CacheMananger.lua", "Lua", 0, 81, 0, 0, 1, 39, 121
"d:\ROBLOX STUDIO\Rojo\UTP\src\ServerStorage\Services\DataMananger.lua", "Lua", 0, 73, 0, 0, 1, 33, 107
"d:\ROBLOX STUDIO\Rojo\UTP\src\ServerStorage\Services\InventoryMananger.lua", "Lua", 0, 81, 0, 0, 2, 28, 111
"d:\ROBLOX STUDIO\Rojo\UTP\src\ServerStorage\Services\PetUtilites.lua", "Lua", 0, 52, 0, 0, 4, 43, 99
"d:\ROBLOX STUDIO\Rojo\UTP\src\ServerStorage\Services\PlayerUtilites.lua", "Lua", 0, 42, 0, 0, 0, 45, 87
"d:\ROBLOX STUDIO\Rojo\UTP\src\ServerStorage\Services\Profile\InventoryPlayers.lua", "Lua", 0, 1, 0, 0, 0, 0, 1
"d:\ROBLOX STUDIO\Rojo\UTP\src\ServerStorage\Services\Profile\PlayersCache.lua", "Lua", 0, 1, 0, 0, 0, 0, 1
"d:\ROBLOX STUDIO\Rojo\UTP\src\ServerStorage\Services\Profile\Profile.lua", "Lua", 0, 1, 0, 0, 0, 0, 1
"d:\ROBLOX STUDIO\Rojo\UTP\src\ServerStorage\Services\Profile\ProfileService.lua", "Lua", 0, 1891, 0, 0, 178, 348, 2417
"d:\ROBLOX STUDIO\Rojo\UTP\src\ServerStorage\Services\Profile\init.meta.json", "JSON", 3, 0, 0, 0, 0, 0, 3
"d:\ROBLOX STUDIO\Rojo\UTP\src\ServerStorage\Services\SkillMananger.lua", "Lua", 0, 36, 0, 0, 2, 25, 63
"d:\ROBLOX STUDIO\Rojo\UTP\src\ServerStorage\Services\SubServices\HitBoxMananger.lua", "Lua", 0, 72, 0, 0, 0, 28, 100
"d:\ROBLOX STUDIO\Rojo\UTP\src\ServerStorage\Services\SubServices\TycoonFunctions.lua", "Lua", 0, 141, 0, 0, 3, 30, 174
"d:\ROBLOX STUDIO\Rojo\UTP\src\ServerStorage\Services\TycoonMananger.lua", "Lua", 0, 193, 0, 0, 2, 56, 251
"d:\ROBLOX STUDIO\Rojo\UTP\src\ServerStorage\Services\Utilities.lua", "Lua", 0, 19, 0, 0, 2, 20, 41
"d:\ROBLOX STUDIO\Rojo\UTP\src\ServerStorage\Services\init.meta.json", "JSON", 3, 0, 0, 0, 0, 0, 3
"d:\ROBLOX STUDIO\Rojo\UTP\src\ServerStorage\SkillSystem\CommonFuncs.lua", "Lua", 0, 28, 0, 0, 0, 11, 39
"d:\ROBLOX STUDIO\Rojo\UTP\src\ServerStorage\SkillSystem\HitBoxMananger.lua", "Lua", 0, 28, 0, 0, 0, 7, 35
"d:\ROBLOX STUDIO\Rojo\UTP\src\ServerStorage\SkillSystem\Skills\Blue.lua", "Lua", 0, 35, 0, 0, 0, 11, 46
"d:\ROBLOX STUDIO\Rojo\UTP\src\ServerStorage\TycoonModel\Boughtitems\FirstDropper\ScriptDropper.server.lua", "Lua", 0, 9, 0, 0, 8, 3, 20
"d:\ROBLOX STUDIO\Rojo\UTP\src\ServerStorage\TycoonModel\Boughtitems\FirstDropper\init.meta.json", "JSON", 3, 0, 0, 0, 0, 0, 3
"d:\ROBLOX STUDIO\Rojo\UTP\src\ServerStorage\TycoonModel\Boughtitems\FourDropper\ScriptDropper.server.lua", "Lua", 0, 10, 0, 0, 5, 4, 19
"d:\ROBLOX STUDIO\Rojo\UTP\src\ServerStorage\TycoonModel\Boughtitems\FourDropper\init.meta.json", "JSON", 3, 0, 0, 0, 0, 0, 3
"d:\ROBLOX STUDIO\Rojo\UTP\src\ServerStorage\TycoonModel\Boughtitems\OwnerOnlyDoor\Button\Script.server.lua", "Lua", 0, 16, 0, 0, 0, 5, 21
"d:\ROBLOX STUDIO\Rojo\UTP\src\ServerStorage\TycoonModel\Boughtitems\OwnerOnlyDoor\Button\init.meta.json", "JSON", 3, 0, 0, 0, 0, 0, 3
"d:\ROBLOX STUDIO\Rojo\UTP\src\ServerStorage\TycoonModel\Boughtitems\OwnerOnlyDoor\Lasers\LaserOwnerDoor.server.lua", "Lua", 0, 17, 0, 0, 0, 11, 28
"d:\ROBLOX STUDIO\Rojo\UTP\src\ServerStorage\TycoonModel\Boughtitems\OwnerOnlyDoor\Lasers\init.meta.json", "JSON", 3, 0, 0, 0, 0, 0, 3
"d:\ROBLOX STUDIO\Rojo\UTP\src\ServerStorage\TycoonModel\Boughtitems\OwnerOnlyDoor\init.meta.json", "JSON", 3, 0, 0, 0, 0, 0, 3
"d:\ROBLOX STUDIO\Rojo\UTP\src\ServerStorage\TycoonModel\Boughtitems\SecondDropper\ScriptDropper.server.lua", "Lua", 0, 10, 0, 0, 5, 4, 19
"d:\ROBLOX STUDIO\Rojo\UTP\src\ServerStorage\TycoonModel\Boughtitems\SecondDropper\init.meta.json", "JSON", 3, 0, 0, 0, 0, 0, 3
"d:\ROBLOX STUDIO\Rojo\UTP\src\ServerStorage\TycoonModel\Boughtitems\UpgradePet\Button\ButtonUpgradePetScript.server.lua", "Lua", 0, 6, 0, 0, 2, 3, 11
"d:\ROBLOX STUDIO\Rojo\UTP\src\ServerStorage\TycoonModel\Boughtitems\UpgradePet\Button\init.meta.json", "JSON", 3, 0, 0, 0, 0, 0, 3
"d:\ROBLOX STUDIO\Rojo\UTP\src\ServerStorage\TycoonModel\Boughtitems\UpgradePet\UpdateValue .server.lua", "Lua", 0, 20, 0, 0, 0, 17, 37
"d:\ROBLOX STUDIO\Rojo\UTP\src\ServerStorage\TycoonModel\Boughtitems\UpgradePet\init.meta.json", "JSON", 3, 0, 0, 0, 0, 0, 3
"d:\ROBLOX STUDIO\Rojo\UTP\src\ServerStorage\TycoonModel\Boughtitems\init.meta.json", "JSON", 3, 0, 0, 0, 0, 0, 3
"d:\ROBLOX STUDIO\Rojo\UTP\src\ServerStorage\TycoonModel\Boughtitems\thirdDropper\ScriptDropper.server.lua", "Lua", 0, 10, 0, 0, 5, 4, 19
"d:\ROBLOX STUDIO\Rojo\UTP\src\ServerStorage\TycoonModel\Boughtitems\thirdDropper\init.meta.json", "JSON", 3, 0, 0, 0, 0, 0, 3
"d:\ROBLOX STUDIO\Rojo\UTP\src\ServerStorage\TycoonModel\Buttons\BackWallsTButton\ButtonPart\BillboardGui\Frame\TextLabel\Script.server.lua", "Lua", 0, 6, 0, 0, 0, 4, 10
"d:\ROBLOX STUDIO\Rojo\UTP\src\ServerStorage\TycoonModel\Buttons\BackWallsTButton\ButtonPart\BillboardGui\Frame\TextLabel\init.meta.json", "JSON", 3, 0, 0, 0, 0, 0, 3
"d:\ROBLOX STUDIO\Rojo\UTP\src\ServerStorage\TycoonModel\Buttons\BackWallsTButton\ButtonPart\BillboardGui\Frame\init.meta.json", "JSON", 3, 0, 0, 0, 0, 0, 3
"d:\ROBLOX STUDIO\Rojo\UTP\src\ServerStorage\TycoonModel\Buttons\BackWallsTButton\ButtonPart\BillboardGui\init.meta.json", "JSON", 3, 0, 0, 0, 0, 0, 3
"d:\ROBLOX STUDIO\Rojo\UTP\src\ServerStorage\TycoonModel\Buttons\BackWallsTButton\ButtonPart\init.meta.json", "JSON", 3, 0, 0, 0, 0, 0, 3
"d:\ROBLOX STUDIO\Rojo\UTP\src\ServerStorage\TycoonModel\Buttons\BackWallsTButton\init.meta.json", "JSON", 3, 0, 0, 0, 0, 0, 3
"d:\ROBLOX STUDIO\Rojo\UTP\src\ServerStorage\TycoonModel\Buttons\ConveyorUpgraderButton\ButtonPart\BillboardGui\Frame\TextLabel\Script.server.lua", "Lua", 0, 6, 0, 0, 0, 4, 10
"d:\ROBLOX STUDIO\Rojo\UTP\src\ServerStorage\TycoonModel\Buttons\ConveyorUpgraderButton\ButtonPart\BillboardGui\Frame\TextLabel\init.meta.json", "JSON", 3, 0, 0, 0, 0, 0, 3
"d:\ROBLOX STUDIO\Rojo\UTP\src\ServerStorage\TycoonModel\Buttons\ConveyorUpgraderButton\ButtonPart\BillboardGui\Frame\init.meta.json", "JSON", 3, 0, 0, 0, 0, 0, 3
"d:\ROBLOX STUDIO\Rojo\UTP\src\ServerStorage\TycoonModel\Buttons\ConveyorUpgraderButton\ButtonPart\BillboardGui\init.meta.json", "JSON", 3, 0, 0, 0, 0, 0, 3
"d:\ROBLOX STUDIO\Rojo\UTP\src\ServerStorage\TycoonModel\Buttons\ConveyorUpgraderButton\ButtonPart\init.meta.json", "JSON", 3, 0, 0, 0, 0, 0, 3
"d:\ROBLOX STUDIO\Rojo\UTP\src\ServerStorage\TycoonModel\Buttons\ConveyorUpgraderButton\init.meta.json", "JSON", 3, 0, 0, 0, 0, 0, 3
"d:\ROBLOX STUDIO\Rojo\UTP\src\ServerStorage\TycoonModel\Buttons\FirstButtonDropper\ButtonPart\BillboardGui\Frame\TextLabel\Script.server.lua", "Lua", 0, 6, 0, 0, 0, 4, 10
"d:\ROBLOX STUDIO\Rojo\UTP\src\ServerStorage\TycoonModel\Buttons\FirstButtonDropper\ButtonPart\BillboardGui\Frame\TextLabel\init.meta.json", "JSON", 3, 0, 0, 0, 0, 0, 3
"d:\ROBLOX STUDIO\Rojo\UTP\src\ServerStorage\TycoonModel\Buttons\FirstButtonDropper\ButtonPart\BillboardGui\Frame\init.meta.json", "JSON", 3, 0, 0, 0, 0, 0, 3
"d:\ROBLOX STUDIO\Rojo\UTP\src\ServerStorage\TycoonModel\Buttons\FirstButtonDropper\ButtonPart\BillboardGui\init.meta.json", "JSON", 3, 0, 0, 0, 0, 0, 3
"d:\ROBLOX STUDIO\Rojo\UTP\src\ServerStorage\TycoonModel\Buttons\FirstButtonDropper\ButtonPart\init.meta.json", "JSON", 3, 0, 0, 0, 0, 0, 3
"d:\ROBLOX STUDIO\Rojo\UTP\src\ServerStorage\TycoonModel\Buttons\FirstButtonDropper\init.meta.json", "JSON", 3, 0, 0, 0, 0, 0, 3
"d:\ROBLOX STUDIO\Rojo\UTP\src\ServerStorage\TycoonModel\Buttons\FirstEggButton\ButtonPart\BillboardGui\Frame\TextLabel\Script.server.lua", "Lua", 0, 6, 0, 0, 0, 4, 10
"d:\ROBLOX STUDIO\Rojo\UTP\src\ServerStorage\TycoonModel\Buttons\FirstEggButton\ButtonPart\BillboardGui\Frame\TextLabel\init.meta.json", "JSON", 3, 0, 0, 0, 0, 0, 3
"d:\ROBLOX STUDIO\Rojo\UTP\src\ServerStorage\TycoonModel\Buttons\FirstEggButton\ButtonPart\BillboardGui\Frame\init.meta.json", "JSON", 3, 0, 0, 0, 0, 0, 3
"d:\ROBLOX STUDIO\Rojo\UTP\src\ServerStorage\TycoonModel\Buttons\FirstEggButton\ButtonPart\BillboardGui\init.meta.json", "JSON", 3, 0, 0, 0, 0, 0, 3
"d:\ROBLOX STUDIO\Rojo\UTP\src\ServerStorage\TycoonModel\Buttons\FirstEggButton\ButtonPart\init.meta.json", "JSON", 3, 0, 0, 0, 0, 0, 3
"d:\ROBLOX STUDIO\Rojo\UTP\src\ServerStorage\TycoonModel\Buttons\FirstEggButton\init.meta.json", "JSON", 3, 0, 0, 0, 0, 0, 3
"d:\ROBLOX STUDIO\Rojo\UTP\src\ServerStorage\TycoonModel\Buttons\FloorTButton\ButtonPart\BillboardGui\Frame\TextLabel\Script.server.lua", "Lua", 0, 6, 0, 0, 0, 4, 10
"d:\ROBLOX STUDIO\Rojo\UTP\src\ServerStorage\TycoonModel\Buttons\FloorTButton\ButtonPart\BillboardGui\Frame\TextLabel\init.meta.json", "JSON", 3, 0, 0, 0, 0, 0, 3
"d:\ROBLOX STUDIO\Rojo\UTP\src\ServerStorage\TycoonModel\Buttons\FloorTButton\ButtonPart\BillboardGui\Frame\init.meta.json", "JSON", 3, 0, 0, 0, 0, 0, 3
"d:\ROBLOX STUDIO\Rojo\UTP\src\ServerStorage\TycoonModel\Buttons\FloorTButton\ButtonPart\BillboardGui\init.meta.json", "JSON", 3, 0, 0, 0, 0, 0, 3
"d:\ROBLOX STUDIO\Rojo\UTP\src\ServerStorage\TycoonModel\Buttons\FloorTButton\ButtonPart\init.meta.json", "JSON", 3, 0, 0, 0, 0, 0, 3
"d:\ROBLOX STUDIO\Rojo\UTP\src\ServerStorage\TycoonModel\Buttons\FloorTButton\init.meta.json", "JSON", 3, 0, 0, 0, 0, 0, 3
"d:\ROBLOX STUDIO\Rojo\UTP\src\ServerStorage\TycoonModel\Buttons\FourButton\ButtonPart\BillboardGui\Frame\TextLabel\Script.server.lua", "Lua", 0, 6, 0, 0, 0, 4, 10
"d:\ROBLOX STUDIO\Rojo\UTP\src\ServerStorage\TycoonModel\Buttons\FourButton\ButtonPart\BillboardGui\Frame\TextLabel\init.meta.json", "JSON", 3, 0, 0, 0, 0, 0, 3
"d:\ROBLOX STUDIO\Rojo\UTP\src\ServerStorage\TycoonModel\Buttons\FourButton\ButtonPart\BillboardGui\Frame\init.meta.json", "JSON", 3, 0, 0, 0, 0, 0, 3
"d:\ROBLOX STUDIO\Rojo\UTP\src\ServerStorage\TycoonModel\Buttons\FourButton\ButtonPart\BillboardGui\init.meta.json", "JSON", 3, 0, 0, 0, 0, 0, 3
"d:\ROBLOX STUDIO\Rojo\UTP\src\ServerStorage\TycoonModel\Buttons\FourButton\ButtonPart\init.meta.json", "JSON", 3, 0, 0, 0, 0, 0, 3
"d:\ROBLOX STUDIO\Rojo\UTP\src\ServerStorage\TycoonModel\Buttons\FourButton\init.meta.json", "JSON", 3, 0, 0, 0, 0, 0, 3
"d:\ROBLOX STUDIO\Rojo\UTP\src\ServerStorage\TycoonModel\Buttons\FrontWallsTButton\ButtonPart\BillboardGui\Frame\TextLabel\Script.server.lua", "Lua", 0, 6, 0, 0, 0, 4, 10
"d:\ROBLOX STUDIO\Rojo\UTP\src\ServerStorage\TycoonModel\Buttons\FrontWallsTButton\ButtonPart\BillboardGui\Frame\TextLabel\init.meta.json", "JSON", 3, 0, 0, 0, 0, 0, 3
"d:\ROBLOX STUDIO\Rojo\UTP\src\ServerStorage\TycoonModel\Buttons\FrontWallsTButton\ButtonPart\BillboardGui\Frame\init.meta.json", "JSON", 3, 0, 0, 0, 0, 0, 3
"d:\ROBLOX STUDIO\Rojo\UTP\src\ServerStorage\TycoonModel\Buttons\FrontWallsTButton\ButtonPart\BillboardGui\init.meta.json", "JSON", 3, 0, 0, 0, 0, 0, 3
"d:\ROBLOX STUDIO\Rojo\UTP\src\ServerStorage\TycoonModel\Buttons\FrontWallsTButton\ButtonPart\init.meta.json", "JSON", 3, 0, 0, 0, 0, 0, 3
"d:\ROBLOX STUDIO\Rojo\UTP\src\ServerStorage\TycoonModel\Buttons\FrontWallsTButton\init.meta.json", "JSON", 3, 0, 0, 0, 0, 0, 3
"d:\ROBLOX STUDIO\Rojo\UTP\src\ServerStorage\TycoonModel\Buttons\OwnerDoorButton\ButtonPart\BillboardGui\Frame\TextLabel\Script.server.lua", "Lua", 0, 6, 0, 0, 0, 4, 10
"d:\ROBLOX STUDIO\Rojo\UTP\src\ServerStorage\TycoonModel\Buttons\OwnerDoorButton\ButtonPart\BillboardGui\Frame\TextLabel\init.meta.json", "JSON", 3, 0, 0, 0, 0, 0, 3
"d:\ROBLOX STUDIO\Rojo\UTP\src\ServerStorage\TycoonModel\Buttons\OwnerDoorButton\ButtonPart\BillboardGui\Frame\init.meta.json", "JSON", 3, 0, 0, 0, 0, 0, 3
"d:\ROBLOX STUDIO\Rojo\UTP\src\ServerStorage\TycoonModel\Buttons\OwnerDoorButton\ButtonPart\BillboardGui\init.meta.json", "JSON", 3, 0, 0, 0, 0, 0, 3
"d:\ROBLOX STUDIO\Rojo\UTP\src\ServerStorage\TycoonModel\Buttons\OwnerDoorButton\ButtonPart\init.meta.json", "JSON", 3, 0, 0, 0, 0, 0, 3
"d:\ROBLOX STUDIO\Rojo\UTP\src\ServerStorage\TycoonModel\Buttons\OwnerDoorButton\init.meta.json", "JSON", 3, 0, 0, 0, 0, 0, 3
"d:\ROBLOX STUDIO\Rojo\UTP\src\ServerStorage\TycoonModel\Buttons\SecondButtonDropper\ButtonPart\BillboardGui\Frame\TextLabel\Script.server.lua", "Lua", 0, 6, 0, 0, 0, 4, 10
"d:\ROBLOX STUDIO\Rojo\UTP\src\ServerStorage\TycoonModel\Buttons\SecondButtonDropper\ButtonPart\BillboardGui\Frame\TextLabel\init.meta.json", "JSON", 3, 0, 0, 0, 0, 0, 3
"d:\ROBLOX STUDIO\Rojo\UTP\src\ServerStorage\TycoonModel\Buttons\SecondButtonDropper\ButtonPart\BillboardGui\Frame\init.meta.json", "JSON", 3, 0, 0, 0, 0, 0, 3
"d:\ROBLOX STUDIO\Rojo\UTP\src\ServerStorage\TycoonModel\Buttons\SecondButtonDropper\ButtonPart\BillboardGui\init.meta.json", "JSON", 3, 0, 0, 0, 0, 0, 3
"d:\ROBLOX STUDIO\Rojo\UTP\src\ServerStorage\TycoonModel\Buttons\SecondButtonDropper\ButtonPart\init.meta.json", "JSON", 3, 0, 0, 0, 0, 0, 3
"d:\ROBLOX STUDIO\Rojo\UTP\src\ServerStorage\TycoonModel\Buttons\SecondButtonDropper\init.meta.json", "JSON", 3, 0, 0, 0, 0, 0, 3
"d:\ROBLOX STUDIO\Rojo\UTP\src\ServerStorage\TycoonModel\Buttons\SecondEggButton\ButtonPart\BillboardGui\Frame\TextLabel\Script.server.lua", "Lua", 0, 6, 0, 0, 0, 4, 10
"d:\ROBLOX STUDIO\Rojo\UTP\src\ServerStorage\TycoonModel\Buttons\SecondEggButton\ButtonPart\BillboardGui\Frame\TextLabel\init.meta.json", "JSON", 3, 0, 0, 0, 0, 0, 3
"d:\ROBLOX STUDIO\Rojo\UTP\src\ServerStorage\TycoonModel\Buttons\SecondEggButton\ButtonPart\BillboardGui\Frame\init.meta.json", "JSON", 3, 0, 0, 0, 0, 0, 3
"d:\ROBLOX STUDIO\Rojo\UTP\src\ServerStorage\TycoonModel\Buttons\SecondEggButton\ButtonPart\BillboardGui\init.meta.json", "JSON", 3, 0, 0, 0, 0, 0, 3
"d:\ROBLOX STUDIO\Rojo\UTP\src\ServerStorage\TycoonModel\Buttons\SecondEggButton\ButtonPart\init.meta.json", "JSON", 3, 0, 0, 0, 0, 0, 3
"d:\ROBLOX STUDIO\Rojo\UTP\src\ServerStorage\TycoonModel\Buttons\SecondEggButton\init.meta.json", "JSON", 3, 0, 0, 0, 0, 0, 3
"d:\ROBLOX STUDIO\Rojo\UTP\src\ServerStorage\TycoonModel\Buttons\StairsTButton\ButtonPart\BillboardGui\Frame\TextLabel\Script.server.lua", "Lua", 0, 6, 0, 0, 0, 4, 10
"d:\ROBLOX STUDIO\Rojo\UTP\src\ServerStorage\TycoonModel\Buttons\StairsTButton\ButtonPart\BillboardGui\Frame\TextLabel\init.meta.json", "JSON", 3, 0, 0, 0, 0, 0, 3
"d:\ROBLOX STUDIO\Rojo\UTP\src\ServerStorage\TycoonModel\Buttons\StairsTButton\ButtonPart\BillboardGui\Frame\init.meta.json", "JSON", 3, 0, 0, 0, 0, 0, 3
"d:\ROBLOX STUDIO\Rojo\UTP\src\ServerStorage\TycoonModel\Buttons\StairsTButton\ButtonPart\BillboardGui\init.meta.json", "JSON", 3, 0, 0, 0, 0, 0, 3
"d:\ROBLOX STUDIO\Rojo\UTP\src\ServerStorage\TycoonModel\Buttons\StairsTButton\ButtonPart\init.meta.json", "JSON", 3, 0, 0, 0, 0, 0, 3
"d:\ROBLOX STUDIO\Rojo\UTP\src\ServerStorage\TycoonModel\Buttons\StairsTButton\init.meta.json", "JSON", 3, 0, 0, 0, 0, 0, 3
"d:\ROBLOX STUDIO\Rojo\UTP\src\ServerStorage\TycoonModel\Buttons\ThirdButton\ButtonPart\BillboardGui\Frame\TextLabel\Script.server.lua", "Lua", 0, 6, 0, 0, 0, 4, 10
"d:\ROBLOX STUDIO\Rojo\UTP\src\ServerStorage\TycoonModel\Buttons\ThirdButton\ButtonPart\BillboardGui\Frame\TextLabel\init.meta.json", "JSON", 3, 0, 0, 0, 0, 0, 3
"d:\ROBLOX STUDIO\Rojo\UTP\src\ServerStorage\TycoonModel\Buttons\ThirdButton\ButtonPart\BillboardGui\Frame\init.meta.json", "JSON", 3, 0, 0, 0, 0, 0, 3
"d:\ROBLOX STUDIO\Rojo\UTP\src\ServerStorage\TycoonModel\Buttons\ThirdButton\ButtonPart\BillboardGui\init.meta.json", "JSON", 3, 0, 0, 0, 0, 0, 3
"d:\ROBLOX STUDIO\Rojo\UTP\src\ServerStorage\TycoonModel\Buttons\ThirdButton\ButtonPart\init.meta.json", "JSON", 3, 0, 0, 0, 0, 0, 3
"d:\ROBLOX STUDIO\Rojo\UTP\src\ServerStorage\TycoonModel\Buttons\ThirdButton\init.meta.json", "JSON", 3, 0, 0, 0, 0, 0, 3
"d:\ROBLOX STUDIO\Rojo\UTP\src\ServerStorage\TycoonModel\Buttons\UpWallsTButton\ButtonPart\BillboardGui\Frame\TextLabel\Script.server.lua", "Lua", 0, 6, 0, 0, 0, 4, 10
"d:\ROBLOX STUDIO\Rojo\UTP\src\ServerStorage\TycoonModel\Buttons\UpWallsTButton\ButtonPart\BillboardGui\Frame\TextLabel\init.meta.json", "JSON", 3, 0, 0, 0, 0, 0, 3
"d:\ROBLOX STUDIO\Rojo\UTP\src\ServerStorage\TycoonModel\Buttons\UpWallsTButton\ButtonPart\BillboardGui\Frame\init.meta.json", "JSON", 3, 0, 0, 0, 0, 0, 3
"d:\ROBLOX STUDIO\Rojo\UTP\src\ServerStorage\TycoonModel\Buttons\UpWallsTButton\ButtonPart\BillboardGui\init.meta.json", "JSON", 3, 0, 0, 0, 0, 0, 3
"d:\ROBLOX STUDIO\Rojo\UTP\src\ServerStorage\TycoonModel\Buttons\UpWallsTButton\ButtonPart\init.meta.json", "JSON", 3, 0, 0, 0, 0, 0, 3
"d:\ROBLOX STUDIO\Rojo\UTP\src\ServerStorage\TycoonModel\Buttons\UpWallsTButton\init.meta.json", "JSON", 3, 0, 0, 0, 0, 0, 3
"d:\ROBLOX STUDIO\Rojo\UTP\src\ServerStorage\TycoonModel\Buttons\UpgradePetButton\ButtonPart\BillboardGui\Frame\TextLabel\Script.server.lua", "Lua", 0, 6, 0, 0, 0, 4, 10
"d:\ROBLOX STUDIO\Rojo\UTP\src\ServerStorage\TycoonModel\Buttons\UpgradePetButton\ButtonPart\BillboardGui\Frame\TextLabel\init.meta.json", "JSON", 3, 0, 0, 0, 0, 0, 3
"d:\ROBLOX STUDIO\Rojo\UTP\src\ServerStorage\TycoonModel\Buttons\UpgradePetButton\ButtonPart\BillboardGui\Frame\init.meta.json", "JSON", 3, 0, 0, 0, 0, 0, 3
"d:\ROBLOX STUDIO\Rojo\UTP\src\ServerStorage\TycoonModel\Buttons\UpgradePetButton\ButtonPart\BillboardGui\init.meta.json", "JSON", 3, 0, 0, 0, 0, 0, 3
"d:\ROBLOX STUDIO\Rojo\UTP\src\ServerStorage\TycoonModel\Buttons\UpgradePetButton\ButtonPart\init.meta.json", "JSON", 3, 0, 0, 0, 0, 0, 3
"d:\ROBLOX STUDIO\Rojo\UTP\src\ServerStorage\TycoonModel\Buttons\UpgradePetButton\init.meta.json", "JSON", 3, 0, 0, 0, 0, 0, 3
"d:\ROBLOX STUDIO\Rojo\UTP\src\ServerStorage\TycoonModel\Buttons\UpgraderButton\ButtonPart\BillboardGui\Frame\TextLabel\Script.server.lua", "Lua", 0, 6, 0, 0, 0, 4, 10
"d:\ROBLOX STUDIO\Rojo\UTP\src\ServerStorage\TycoonModel\Buttons\UpgraderButton\ButtonPart\BillboardGui\Frame\TextLabel\init.meta.json", "JSON", 3, 0, 0, 0, 0, 0, 3
"d:\ROBLOX STUDIO\Rojo\UTP\src\ServerStorage\TycoonModel\Buttons\UpgraderButton\ButtonPart\BillboardGui\Frame\init.meta.json", "JSON", 3, 0, 0, 0, 0, 0, 3
"d:\ROBLOX STUDIO\Rojo\UTP\src\ServerStorage\TycoonModel\Buttons\UpgraderButton\ButtonPart\BillboardGui\init.meta.json", "JSON", 3, 0, 0, 0, 0, 0, 3
"d:\ROBLOX STUDIO\Rojo\UTP\src\ServerStorage\TycoonModel\Buttons\UpgraderButton\ButtonPart\init.meta.json", "JSON", 3, 0, 0, 0, 0, 0, 3
"d:\ROBLOX STUDIO\Rojo\UTP\src\ServerStorage\TycoonModel\Buttons\UpgraderButton\init.meta.json", "JSON", 3, 0, 0, 0, 0, 0, 3
"d:\ROBLOX STUDIO\Rojo\UTP\src\ServerStorage\TycoonModel\Buttons\WindowsTButton\ButtonPart\BillboardGui\Frame\TextLabel\Script.server.lua", "Lua", 0, 6, 0, 0, 0, 4, 10
"d:\ROBLOX STUDIO\Rojo\UTP\src\ServerStorage\TycoonModel\Buttons\WindowsTButton\ButtonPart\BillboardGui\Frame\TextLabel\init.meta.json", "JSON", 3, 0, 0, 0, 0, 0, 3
"d:\ROBLOX STUDIO\Rojo\UTP\src\ServerStorage\TycoonModel\Buttons\WindowsTButton\ButtonPart\BillboardGui\Frame\init.meta.json", "JSON", 3, 0, 0, 0, 0, 0, 3
"d:\ROBLOX STUDIO\Rojo\UTP\src\ServerStorage\TycoonModel\Buttons\WindowsTButton\ButtonPart\BillboardGui\init.meta.json", "JSON", 3, 0, 0, 0, 0, 0, 3
"d:\ROBLOX STUDIO\Rojo\UTP\src\ServerStorage\TycoonModel\Buttons\WindowsTButton\ButtonPart\init.meta.json", "JSON", 3, 0, 0, 0, 0, 0, 3
"d:\ROBLOX STUDIO\Rojo\UTP\src\ServerStorage\TycoonModel\Buttons\WindowsTButton\init.meta.json", "JSON", 3, 0, 0, 0, 0, 0, 3
"d:\ROBLOX STUDIO\Rojo\UTP\src\ServerStorage\TycoonModel\Buttons\init.meta.json", "JSON", 3, 0, 0, 0, 0, 0, 3
"d:\ROBLOX STUDIO\Rojo\UTP\src\ServerStorage\TycoonModel\MainItems\ConveyorBelt\CollectorPart\CollectScript.server.lua", "Lua", 0, 10, 0, 0, 0, 4, 14
"d:\ROBLOX STUDIO\Rojo\UTP\src\ServerStorage\TycoonModel\MainItems\ConveyorBelt\CollectorPart\init.meta.json", "JSON", 3, 0, 0, 0, 0, 0, 3
"d:\ROBLOX STUDIO\Rojo\UTP\src\ServerStorage\TycoonModel\MainItems\ConveyorBelt\ConveyorPart1\Script.server.lua", "Lua", 0, 4, 0, 0, 0, 2, 6
"d:\ROBLOX STUDIO\Rojo\UTP\src\ServerStorage\TycoonModel\MainItems\ConveyorBelt\ConveyorPart1\init.meta.json", "JSON", 3, 0, 0, 0, 0, 0, 3
"d:\ROBLOX STUDIO\Rojo\UTP\src\ServerStorage\TycoonModel\MainItems\ConveyorBelt\ConveyorPart2\Script.server.lua", "Lua", 0, 4, 0, 0, 0, 2, 6
"d:\ROBLOX STUDIO\Rojo\UTP\src\ServerStorage\TycoonModel\MainItems\ConveyorBelt\ConveyorPart2\init.meta.json", "JSON", 3, 0, 0, 0, 0, 0, 3
"d:\ROBLOX STUDIO\Rojo\UTP\src\ServerStorage\TycoonModel\MainItems\ConveyorBelt\init.meta.json", "JSON", 3, 0, 0, 0, 0, 0, 3
"d:\ROBLOX STUDIO\Rojo\UTP\src\ServerStorage\TycoonModel\MainItems\OwnerDoor\MainDoor\OwnerScript.server.lua", "Lua", 0, 18, 0, 0, 2, 10, 30
"d:\ROBLOX STUDIO\Rojo\UTP\src\ServerStorage\TycoonModel\MainItems\OwnerDoor\MainDoor\init.meta.json", "JSON", 3, 0, 0, 0, 0, 0, 3
"d:\ROBLOX STUDIO\Rojo\UTP\src\ServerStorage\TycoonModel\MainItems\OwnerDoor\init.meta.json", "JSON", 3, 0, 0, 0, 0, 0, 3
"d:\ROBLOX STUDIO\Rojo\UTP\src\ServerStorage\TycoonModel\MainItems\init.meta.json", "JSON", 3, 0, 0, 0, 0, 0, 3
"d:\ROBLOX STUDIO\Rojo\UTP\src\ServerStorage\TycoonModel\Scripts\BuildItems.server.lua", "Lua", 0, 36, 0, 0, 0, 30, 66
"d:\ROBLOX STUDIO\Rojo\UTP\src\ServerStorage\TycoonModel\Scripts\ButtonCashScript.server.lua", "Lua", 0, 41, 0, 0, 0, 18, 59
"d:\ROBLOX STUDIO\Rojo\UTP\src\ServerStorage\TycoonModel\Scripts\ButtonTycoon.server.lua", "Lua", 0, 71, 0, 0, 1, 10, 82
"d:\ROBLOX STUDIO\Rojo\UTP\src\ServerStorage\TycoonModel\Scripts\TycoonServiceClient.server.lua", "Lua", 0, 28, 0, 0, 4, 13, 45
"d:\ROBLOX STUDIO\Rojo\UTP\src\ServerStorage\TycoonModel\Scripts\UpgraderSum.server.lua", "Lua", 0, 28, 0, 0, 2, 14, 44
"d:\ROBLOX STUDIO\Rojo\UTP\src\ServerStorage\TycoonModel\Scripts\init.meta.json", "JSON", 3, 0, 0, 0, 0, 0, 3
"d:\ROBLOX STUDIO\Rojo\UTP\src\ServerStorage\TycoonModel\init.meta.json", "JSON", 3, 0, 0, 0, 0, 0, 3
"d:\ROBLOX STUDIO\Rojo\UTP\src\StarterGui\GuiTeste\Frame1\Animator\.source.lua", "Lua", 0, 28, 0, 0, 1, 12, 41
"d:\ROBLOX STUDIO\Rojo\UTP\src\StarterGui\GuiTeste\Frame1\Animator\Tweens\CloseGui.lua", "Lua", 0, 37, 0, 0, 0, 1, 38
"d:\ROBLOX STUDIO\Rojo\UTP\src\StarterGui\GuiTeste\Frame1\Animator\Tweens\DownGui.lua", "Lua", 0, 15, 0, 0, 0, 1, 16
"d:\ROBLOX STUDIO\Rojo\UTP\src\StarterGui\GuiTeste\Frame1\Animator\Tweens\OpenGui.lua", "Lua", 0, 37, 0, 0, 1, 4, 42
"d:\ROBLOX STUDIO\Rojo\UTP\src\StarterGui\GuiTeste\Frame1\Animator\Tweens\UpGui.lua", "Lua", 0, 15, 0, 0, 0, 1, 16
"d:\ROBLOX STUDIO\Rojo\UTP\src\StarterGui\GuiTeste\Frame1\Animator\Tweens\init.meta.json", "JSON", 3, 0, 0, 0, 0, 0, 3
"d:\ROBLOX STUDIO\Rojo\UTP\src\StarterGui\GuiTeste\Frame1\Animator\init.lua", "Lua", 0, 28, 0, 0, 1, 12, 41
"d:\ROBLOX STUDIO\Rojo\UTP\src\StarterGui\GuiTeste\Frame1\init.meta.json", "JSON", 4, 0, 0, 0, 0, 0, 4
"d:\ROBLOX STUDIO\Rojo\UTP\src\StarterGui\GuiTeste\init.meta.json", "JSON", 4, 0, 0, 0, 0, 0, 4
"d:\ROBLOX STUDIO\Rojo\UTP\src\StarterGui\ScreenGui\MainFrame\Cash\TextLabel\DisplayCashScript.client.lua", "Lua", 0, 9, 0, 0, 0, 10, 19
"d:\ROBLOX STUDIO\Rojo\UTP\src\StarterGui\ScreenGui\MainFrame\Cash\TextLabel\init.meta.json", "JSON", 4, 0, 0, 0, 0, 0, 4
"d:\ROBLOX STUDIO\Rojo\UTP\src\StarterGui\ScreenGui\MainFrame\Cash\init.meta.json", "JSON", 4, 0, 0, 0, 0, 0, 4
"d:\ROBLOX STUDIO\Rojo\UTP\src\StarterGui\ScreenGui\MainFrame\init.meta.json", "JSON", 4, 0, 0, 0, 0, 0, 4
"d:\ROBLOX STUDIO\Rojo\UTP\src\StarterGui\ScreenGui\init.meta.json", "JSON", 4, 0, 0, 0, 0, 0, 4
"d:\ROBLOX STUDIO\Rojo\UTP\src\StarterPlayer\StarterCharacterScripts\Animate.client.lua", "Lua", 0, 147, 0, 0, 0, 28, 175
"d:\ROBLOX STUDIO\Rojo\UTP\src\StarterPlayer\StarterCharacterScripts\AnimateBkg.client.lua", "Lua", 0, 634, 0, 0, 47, 124, 805
"d:\ROBLOX STUDIO\Rojo\UTP\src\StarterPlayer\StarterPlayerScripts\GameClient.client.lua", "Lua", 0, 34, 0, 0, 6, 22, 62
"d:\ROBLOX STUDIO\Rojo\UTP\src\StarterPlayer\StarterPlayerScripts\GuiControlService.client.lua", "Lua", 0, 66, 0, 0, 3, 50, 119
"d:\ROBLOX STUDIO\Rojo\UTP\src\StarterPlayer\StarterPlayerScripts\Pet_Follower.client.lua", "Lua", 0, 54, 0, 0, 2, 8, 64
"d:\ROBLOX STUDIO\Rojo\UTP\src\Workspace\CenarioAssets\Model\Controler Base\Copy Right Text.server.lua", "Lua", 0, 0, 0, 0, 7, 0, 7
"d:\ROBLOX STUDIO\Rojo\UTP\src\Workspace\CenarioAssets\Model\Controler Base\Mesh Of Original Owner.server.lua", "Lua", 0, 0, 0, 0, 2, 0, 2
"d:\ROBLOX STUDIO\Rojo\UTP\src\Workspace\CenarioAssets\Model\Controler Base\init.meta.json", "JSON", 4, 0, 0, 0, 0, 0, 4
"d:\ROBLOX STUDIO\Rojo\UTP\src\Workspace\CenarioAssets\Model\Part\Copy Right Text.server.lua", "Lua", 0, 0, 0, 0, 7, 0, 7
"d:\ROBLOX STUDIO\Rojo\UTP\src\Workspace\CenarioAssets\Model\Part\init.meta.json", "JSON", 4, 0, 0, 0, 0, 0, 4
"d:\ROBLOX STUDIO\Rojo\UTP\src\Workspace\CenarioAssets\Model\init.meta.json", "JSON", 4, 0, 0, 0, 0, 0, 4
"d:\ROBLOX STUDIO\Rojo\UTP\src\Workspace\CenarioAssets\Rig\Animate.client.lua", "Lua", 0, 634, 0, 0, 47, 124, 805
"d:\ROBLOX STUDIO\Rojo\UTP\src\Workspace\CenarioAssets\Rig\Animate.meta.json", "JSON", 3, 0, 0, 0, 0, 0, 3
"d:\ROBLOX STUDIO\Rojo\UTP\src\Workspace\CenarioAssets\Rig\init.meta.json", "JSON", 4, 0, 0, 0, 0, 0, 4
"d:\ROBLOX STUDIO\Rojo\UTP\src\Workspace\CenarioAssets\Teclado RGB -By gatotou5r\Part\Smooth RGB Script.server.lua", "Lua", 0, 8, 0, 0, 0, 1, 9
"d:\ROBLOX STUDIO\Rojo\UTP\src\Workspace\CenarioAssets\Teclado RGB -By gatotou5r\Part\init.meta.json", "JSON", 4, 0, 0, 0, 0, 0, 4
"d:\ROBLOX STUDIO\Rojo\UTP\src\Workspace\CenarioAssets\Teclado RGB -By gatotou5r\init.meta.json", "JSON", 4, 0, 0, 0, 0, 0, 4
"d:\ROBLOX STUDIO\Rojo\UTP\src\Workspace\CenarioAssets\d\Controler Base\Copy Right Text.server.lua", "Lua", 0, 0, 0, 0, 7, 0, 7
"d:\ROBLOX STUDIO\Rojo\UTP\src\Workspace\CenarioAssets\d\Controler Base\Mesh Of Original Owner.server.lua", "Lua", 0, 0, 0, 0, 2, 0, 2
"d:\ROBLOX STUDIO\Rojo\UTP\src\Workspace\CenarioAssets\d\Controler Base\init.meta.json", "JSON", 4, 0, 0, 0, 0, 0, 4
"d:\ROBLOX STUDIO\Rojo\UTP\src\Workspace\CenarioAssets\d\Part\Copy Right Text.server.lua", "Lua", 0, 0, 0, 0, 7, 0, 7
"d:\ROBLOX STUDIO\Rojo\UTP\src\Workspace\CenarioAssets\d\Part\init.meta.json", "JSON", 4, 0, 0, 0, 0, 0, 4
"d:\ROBLOX STUDIO\Rojo\UTP\src\Workspace\CenarioAssets\d\init.meta.json", "JSON", 4, 0, 0, 0, 0, 0, 4
"d:\ROBLOX STUDIO\Rojo\UTP\src\Workspace\CenarioAssets\init.meta.json", "JSON", 3, 0, 0, 0, 0, 0, 3
"d:\ROBLOX STUDIO\Rojo\UTP\src\Workspace\Model\Controler Base\Copy Right Text.server.lua", "Lua", 0, 0, 0, 0, 7, 0, 7
"d:\ROBLOX STUDIO\Rojo\UTP\src\Workspace\Model\Controler Base\Mesh Of Original Owner.server.lua", "Lua", 0, 0, 0, 0, 2, 0, 2
"d:\ROBLOX STUDIO\Rojo\UTP\src\Workspace\Model\Controler Base\init.meta.json", "JSON", 3, 0, 0, 0, 0, 0, 3
"d:\ROBLOX STUDIO\Rojo\UTP\src\Workspace\Model\Part\Copy Right Text.server.lua", "Lua", 0, 0, 0, 0, 7, 0, 7
"d:\ROBLOX STUDIO\Rojo\UTP\src\Workspace\Model\Part\init.meta.json", "JSON", 3, 0, 0, 0, 0, 0, 3
"d:\ROBLOX STUDIO\Rojo\UTP\src\Workspace\Model\init.meta.json", "JSON", 3, 0, 0, 0, 0, 0, 3
"d:\ROBLOX STUDIO\Rojo\UTP\src\Workspace\Rig\Animate.client.lua", "Lua", 0, 634, 0, 0, 47, 124, 805
"d:\ROBLOX STUDIO\Rojo\UTP\src\Workspace\Rig\Animate.meta.json", "JSON", 3, 0, 0, 0, 0, 0, 3
"d:\ROBLOX STUDIO\Rojo\UTP\src\Workspace\Rig\Animate\.source.client.lua", "Lua", 0, 634, 0, 0, 47, 124, 805
"d:\ROBLOX STUDIO\Rojo\UTP\src\Workspace\Rig\Animate\init.meta.json", "JSON", 3, 0, 0, 0, 0, 0, 3
"d:\ROBLOX STUDIO\Rojo\UTP\src\Workspace\Rig\init.meta.json", "JSON", 4, 0, 0, 0, 0, 0, 4
"d:\ROBLOX STUDIO\Rojo\UTP\src\Workspace\TycoonModel\MainItems\ConveyorBelt\ConveyorPart1\Script.server.lua", "Lua", 0, 4, 0, 0, 0, 2, 6
"d:\ROBLOX STUDIO\Rojo\UTP\src\Workspace\TycoonModel\MainItems\ConveyorBelt\ConveyorPart1\init.meta.json", "JSON", 4, 0, 0, 0, 0, 0, 4
"d:\ROBLOX STUDIO\Rojo\UTP\src\Workspace\TycoonModel\MainItems\ConveyorBelt\ConveyorPart2\Script.server.lua", "Lua", 0, 4, 0, 0, 0, 2, 6
"d:\ROBLOX STUDIO\Rojo\UTP\src\Workspace\TycoonModel\MainItems\ConveyorBelt\ConveyorPart2\init.meta.json", "JSON", 4, 0, 0, 0, 0, 0, 4
"d:\ROBLOX STUDIO\Rojo\UTP\src\Workspace\TycoonModel\MainItems\ConveyorBelt\init.meta.json", "JSON", 4, 0, 0, 0, 0, 0, 4
"d:\ROBLOX STUDIO\Rojo\UTP\src\Workspace\TycoonModel\MainItems\init.meta.json", "JSON", 3, 0, 0, 0, 0, 0, 3
"d:\ROBLOX STUDIO\Rojo\UTP\src\Workspace\TycoonModel\init.meta.json", "JSON", 4, 0, 0, 0, 0, 0, 4
"d:\ROBLOX STUDIO\Rojo\UTP\src\Workspace\d\Controler Base\Copy Right Text.server.lua", "Lua", 0, 0, 0, 0, 7, 0, 7
"d:\ROBLOX STUDIO\Rojo\UTP\src\Workspace\d\Controler Base\Mesh Of Original Owner.server.lua", "Lua", 0, 0, 0, 0, 2, 0, 2
"d:\ROBLOX STUDIO\Rojo\UTP\src\Workspace\d\Controler Base\init.meta.json", "JSON", 3, 0, 0, 0, 0, 0, 3
"d:\ROBLOX STUDIO\Rojo\UTP\src\Workspace\d\Part\Copy Right Text.server.lua", "Lua", 0, 0, 0, 0, 7, 0, 7
"d:\ROBLOX STUDIO\Rojo\UTP\src\Workspace\d\Part\init.meta.json", "JSON", 3, 0, 0, 0, 0, 0, 3
"d:\ROBLOX STUDIO\Rojo\UTP\src\Workspace\d\init.meta.json", "JSON", 3, 0, 0, 0, 0, 0, 3
"d:\ROBLOX STUDIO\Rojo\UTP\src\Workspace\rasda\Animate.client.lua", "Lua", 0, 634, 0, 0, 47, 124, 805
"d:\ROBLOX STUDIO\Rojo\UTP\src\Workspace\rasda\Animate.meta.json", "JSON", 3, 0, 0, 0, 0, 0, 3
"d:\ROBLOX STUDIO\Rojo\UTP\src\Workspace\rasda\init.meta.json", "JSON", 4, 0, 0, 0, 0, 0, 4
"Total", "-", 7594, 17447, 578, 203, 1159, 4573, 31554